1,DR JITENDRA SINGH,Bharatiya Janata Party,566833,4243,571076,U084
2,CH LAL SINGH,Indian National Congress,444151,2552,446703,U084
3,GHULAM MOHD SAROORI,Independent,39519,80,39599,U084
4,MEHRAJ DIN,Independent,9055,27,9082,U084
5,AMIT KUMAR,Bahujan Samaj Party,8559,83,8642,U084
6,MOHD ALI GUJJAR,Independent,7139,19,7158,U084
7,MANOJ KUMAR,Ekam Sanatan Bharat Dal,6778,56,6834,U084
8,BALWAN SINGH,Jammu & Kashmir National Panthers Party (Bhim),3243,49,3292,U084
9,SWARN VEER SINGH JARAL,Independent,3071,17,3088,U084
10,DR PANKAJ SHARMA,Independent,2201,46,2247,U084
11,RAJESH MANCHANDA,Independent,1575,30,1605,U084
12,SACHIN GUPTA,Independent,1457,6,1463,U084
13,NOTA,None of the Above,12891,47,12938,U084
14,CHAMALA KIRAN KUMAR REDDY,Indian National Congress,623762,5381,629143,S2914
15,DR. BOORA NARSAIAH GOUD,Bharatiya Janata Party,401513,5460,406973,S2914
16,KYAMA MALLESH,Bharat Rashtra Samithi,254838,1349,256187,S2914
17,MAHAMD JAHANGIR,Communist Party of India  (Marxist),28412,318,28730,S2914
18,RAMESH GOUD THALLAPELLY,Alliance of Democratic Reforms Party,8130,16,8146,S2914
19,AITARAJU ABENDER,Bahujan Samaj Party,7703,66,7769,S2914
20,ASURA BALU,Independent,5747,3,5750,S2914
21,PULIGILLA BIXAPATHI YADAV,National Nava Kranthi Party,4718,0,4718,S2914
22,BUSHIPAKA VENKATAIAH,Independent,4674,1,4675,S2914
23,POOSA SRINIVAS,Telangana Rashtra Punahnirmana Samithi,4431,2,4433,S2914
24,NARENDRAA VEMULA,Jai Swaraj Party,4303,1,4304,S2914
25,KONGARI LINGA SWAMY,Dharma Samaj Party,4029,64,4093,S2914
26,TARIGOPPULA MAHENDER,Social Justice Party of India,3088,1,3089,S2914
27,KARINGULA YADAGIRI,Independent,2607,5,2612,S2914
28,BETHI NARENDER,Independent,2168,0,2168,S2914
29,M. GANESH,Pyramid Party of India,1996,14,2010,S2914
30,MALLEBOINA PARAMESH YADAV,Independent,1895,2,1897,S2914
31,LINGIDI. VENKATESWARLU,Prajavani  Party,1792,0,1792,S2914
32,V. SADANANDA REDDY,People Protection Party,1734,3,1737,S2914
33,DHERAVATH GOPI NAIK,Jai Maha Bharath Party,1678,4,1682,S2914
34,PENTA RAMESH,Independent,1646,1,1647,S2914
35,RACHA SUBHADRA REDDY,Socialist Party (India),1444,21,1465,S2914
36,VARIKUPPALA. KRISHNA VADDERA,Independent,1361,5,1366,S2914
37,BASHABOINA LAKSHMAIAH,Independent,1319,1,1320,S2914
38,NUNE VENKAT SWAMY,Independent,919,4,923,S2914
39,NARRI. SWAMY KURUMA,Independent,897,1,898,S2914
40,JANGA. SUJATHANAVEEN REDDY,Independent,847,0,847,S2914
41,ERRA SURYAM,Viduthalai Chiruthaigal Katchi,777,1,778,S2914
42,"KONGARI, MALLAIAH",Independent,631,2,633,S2914
43,DR : MORIGADI KRISHNA,Independent,616,1,617,S2914
44,KANDE. RAMARAJU,Independent,577,2,579,S2914
45,KOTHOJU SRINIVASU,National Maha Sabha Party,567,2,569,S2914
46,AMIREDDY KIRAN REDDY,Independent,540,1,541,S2914
47,CHANDU NAYAK MEGAVATH,Independent,501,1,502,S2914
48,KADIRE KIRAN KUMAR,Bahujan Republican  Socialist Party,476,2,478,S2914
49,KARUNAKAR REDDY NALLA,Jai Bharat National Party,446,1,447,S2914
50,KANDADI. MANIPAL REDDY,Telangana Republican Party,432,1,433,S2914
51,UDARI MALLESH,Independent,404,2,406,S2914
52,ANIL KUMAR GADEPAKA,Independent,390,3,393,S2914
53,NOTA,None of the Above,4571,75,4646,S2914
54,AMBICA G LAKSHMINARAYANA VALMIKI,Telugu Desam,755862,12383,768245,S0119
55,MALAGUNDLA SANKAR NARAYANA,Yuvajana Sramika Rythu Congress Party,573769,5921,579690,S0119
56,MALLIKARJUNA VAJJALA,Indian National Congress,41954,1263,43217,S0119
57,G.V.RAMANA REDDY,Independent,6436,3,6439,S0119
58,BANASI NARAYANAPPA,Bahujan Samaj Party,6280,116,6396,S0119
59,V.MURALI PRASAD REDDY,Independent,5775,3,5778,S0119
60,DR.NALLANI RAMESH NAIDU,Andhra Rastra Praja Samithi,4862,127,4989,S0119
61,M.SURENDRA,Pyramid Party of India,2927,8,2935,S0119
62,U.C.VENKATASUBBAIAH,Jaathia Chethi Vruthula Ikya Vedika Party,2533,7,2540,S0119
63,P.CHOWDESWARI,Independent,1514,4,1518,S0119
64,VADLA KESAVAIAH,Independent,1488,6,1494,S0119
65,B.RAGHAVENDRA PRASAD,Independent,1317,1,1318,S0119
66,KETHIREDDY RAGHUNATHAREDDY,Independent,1086,5,1091,S0119
67,LOKANATH GOWD SURAGOWINI,Independent,1085,6,1091,S0119
68,SREERANGARAJULA GOPINATH ROYAL,Independent,903,1,904,S0119
69,SHAIK.NIZAM,Samajwadi Party,749,4,753,S0119
70,RAMAVTH CHINNA RAMAPPA NAIK,Jaibhim Rao Bharat Party,735,10,745,S0119
71,KURUBA MALLIKARJUNA.S.,All India Kisan Janatha party,574,4,578,S0119
72,B.NAGAMUTHYALU,Socialist Unity Centre Of India (COMMUNIST),566,4,570,S0119
73,SRINIVASA RAJU.O,Bhartiya Panchyat Party,489,5,494,S0119
74,DURGA PRASAD D BYATARAYANAJI,Challengers Party,439,5,444,S0119
75,NOTA,None of the Above,9014,185,9199,S0119
76,SANJAY SETH,Bharatiya Janata Party,658975,5757,664732,S278
77,YASHASWINI SAHAY,Indian National Congress,537646,6574,544220,S278
78,DEVENDRA NATH MAHTO,Independent,130526,2121,132647,S278
79,SOMA SINGH,Jai Maha Bharath Party,10340,1,10341,S278
80,NIPU SINGH,Rashtriya Jansangharsh Swaraj Party,7793,10,7803,S278
81,DHANANJAY BHAGAT “GANDHI“,Mera Adhikaar Rashtriya Dal,6784,15,6799,S278
82,SHYAM  BIHARI PRAJAPATI,Bhagidari Party(P),6524,6,6530,S278
83,MANOJ KUMAR,Bahujan Samaj Party,6383,44,6427,S278
84,RAMHARI GOPE,Ambedkarite Party of India,6304,5,6309,S278
85,ANJANI PANDEY,Independent,5386,11,5397,S278
86,SARWESHWARI SAHU,Ekam Sanatan Bharat Dal,4794,8,4802,S278
87,HARINATH SAHU,Lokhit Adhikar Party,4120,16,4136,S278
88,HEMNTI DEVI,Samata Party,4069,11,4080,S278
89,RANJANA GIRI,Republican Party of India (A),3206,2,3208,S278
90,BIRENDRA NATH MANJHI,Abua Jharkhand Party,3130,25,3155,S278
91,DHARMENDRA TIWARY,Bhartiya Jantantra Morcha,3072,22,3094,S278
92,PRAWEEN KACHHAP,Sampoorna Bharat Kranti Party,2870,74,2944,S278
93,PRABEEN CHANDRA MAHATO,Independent,2852,7,2859,S278
94,SANTOSH KUMAR JAISWAL,Independent,2782,5,2787,S278
95,PANKAJ KUMAR RAVI,Peoples Party of India (Democratic),2756,7,2763,S278
96,MANORANJAN BHATTACHARYA,Independent,2537,2,2539,S278
97,AINUL ANSARI,Independent,2533,4,2537,S278
98,BINOD ORAON,Bahujan Mukti Party,2523,66,2589,S278
99,MINTU PASWAN,Socialist Unity Centre Of India (COMMUNIST),2151,13,2164,S278
100,KOLESHWAR MAHTO,Independent,1702,6,1708,S278
101,KAMESHWAR PRASAD SAW,Independent,1644,2,1646,S278
102,ARSHAD AYUB,Independent,1411,1,1412,S278
103,NOTA,None of the Above,8046,107,8153,S278
104,KANWAR SINGH TANWAR,Bharatiya Janata Party,475210,1296,476506,S249
105,KUNWAR DANISH ALI,Indian National Congress,447343,493,447836,S249
106,MUJAHID HUSAIN,Bahujan Samaj Party,163885,214,164099,S249
107,DHANISH,Independent,3615,2,3617,S249
108,SURESH,Independent,2716,1,2717,S249
109,JEETPAL RANA,Independent,2550,6,2556,S249
110,SUHEL HAIDER,Akhil Bhartiya Parivar Party,2492,12,2504,S249
111,NARENDRA SINGH,Independent,1776,3,1779,S249
112,NAEEMUDDIN,Independent,1002,2,1004,S249
113,KUSHAGRA,Independent,856,2,858,S249
114,KASHIF HUSAIN,Independent,677,2,679,S249
115,KUMDESH KUMAR,Independent,627,8,635,S249
116,NOTA,None of the Above,5886,14,5900,S249
117,RADHESHYAM RATHIYA,Bharatiya Janata Party,806667,1608,808275,S262
118,DR. MENKA DEVI SINGH,Indian National Congress,566487,1397,567884,S262
119,INNOCENT KUJUR - BIDANA ORAON,Bahujan Samaj Party,15493,107,15600,S262
120,ALBERT MING,Hamar Raj Party,10915,44,10959,S262
121,PRAKASH KUMAR URANW,Independent,7719,3,7722,S262
122,RUPNARAYAN EKKA,Independent,7410,10,7420,S262
123,GOWARDHAN RATHIA,Independent,4591,2,4593,S262
124,POOJA SIDAR,Independent,4159,8,4167,S262
125,MADAN PRASAD GOND,Gondvana Gantantra Party,3007,8,3015,S262
126,GULESHWAR PAINKRA,Bhartiya Shakti Chetna Party,2618,8,2626,S262
127,UDAY KUMAR RATHIA,Independent,2127,2,2129,S262
128,ABHAY KUMAR EKKA,Independent,1808,17,1825,S262
129,BADAL EKKA,Sarv Adi Dal,1714,14,1728,S262
130,NOTA,None of the Above,14993,29,15022,S262
131,KHALILUR RAHAMAN,All India Trinamool Congress,543449,978,544427,S259
132,MURTOJA HOSSAIN BOKUL,Indian National Congress,427105,685,427790,S259
133,DHANANJAY GHOSH,Bharatiya Janata Party,339868,946,340814,S259
134,REJAUL MONDAL,Independent,7500,0,7500,S259
135,SAJAHAN BISWAS,All India Secular Front,6847,11,6858,S259
136,MUKTIPADA KONAI,Independent,5670,1,5671,S259
137,ASHISH BHUIMALI,Independent,3949,2,3951,S259
138,MD SARWARUL ISLAM SARKAR,Bahujan Samaj Party,3511,4,3515,S259
139,MD SAHABUDDIN,Social Democratic Party Of India,3489,7,3496,S259
140,SAMIRUDDIN,Socialist Unity Centre Of India (COMMUNIST),1946,4,1950,S259
141,PARIMAL GHOSH,Independent,1928,3,1931,S259
142,SANUAR ALI,Bharatheeya Jawan Kisan Party,1698,2,1700,S259
143,RAJIB CHATTERJEE,Bhartiya Lokmat Rashtrwadi Party,1527,5,1532,S259
144,MD ASADUL BISWAS,Independent,1340,0,1340,S259
145,NOTA,None of the Above,17135,23,17158,S259
146,SHOBHA KARANDLAJE,Bharatiya Janata Party,982805,3244,986049,S1024
147,PROFESSOR M.V RAJEEV GOWDA,Indian National Congress,725190,1383,726573,S1024
148,GOVINDAIAH,Bahujan Samaj Party,4614,17,4631,S1024
149,SANTHOSH M,Uttama Prajaakeeya Party,3450,11,3461,S1024
150,UDAYA SHANKAR.G,Prahar Janshakti Party,2676,2,2678,S1024
151,LAKSHMI SRIHARI.J.N.,Independent,2091,3,2094,S1024
152,DILIP KUMAR I.S.,Independent,1896,7,1903,S1024
153,K.M.MAHADEVA,Independent,1716,4,1720,S1024
154,K.V.NANJUNDASWAMY,Independent,1363,2,1365,S1024
155,SHOBHA,Independent,1272,8,1280,S1024
156,Y.R.KALLESHWARI,Samajwadi Janata Party(Karnataka),1072,5,1077,S1024
157,NIRMALA H.L,Socialist Unity Centre Of India (COMMUNIST),972,5,977,S1024
158,H.R.NATARAJ,Independent,857,4,861,S1024
159,BHASKAR ANKALAMADUGU SHIVAREDDY,Independent,831,0,831,S1024
160,SHIVAKUMAR. B,Karnataka Rashtra Samithi,813,4,817,S1024
161,SUDHA.  V,Independent,650,7,657,S1024
162,KRISHNAIAH,Rashtriya Samaj Dal (R),556,3,559,S1024
163,HEBBAL VENKATESH.J,Republican Party of India (A),422,3,425,S1024
164,"GLOBE STAR J. JAI SIMHA VARMA, B E.",Gareeb Aadmi Party,356,3,359,S1024
165,SHOBAN BABU  V,Indian Labour Party (Ambedkar Phule),315,5,320,S1024
166,PARASAPPA BHEEMAPPA GAJJERI,Rani Chennamma Party,313,0,313,S1024
167,NOTA,None of the Above,13499,55,13554,S1024
168,SALENG A SANGMA,Indian National Congress,382058,1861,383919,S152
169,AGATHA K SANGMA,National People's Party,227210,1468,228678,S152
170,ZENITH M SANGMA,All India Trinamool Congress,48518,191,48709,S152
171,LABENN CH MARAK,Independent,6846,64,6910,S152
172,NOTA,None of the Above,5809,31,5840,S152
173,SAJDA AHMED,All India Trinamool Congress,722586,2036,724622,S2526
174,ARUNUDAY PAULCHOWDHURY,Bharatiya Janata Party,504611,1338,505949,S2526
175,AZAHAR MOLLICK,Indian National Congress,78304,285,78589,S2526
176,MOFIKUL ISLAM,All India Secular Front,38971,20,38991,S2526
177,ARIT KARAK,Independent,7287,5,7292,S2526
178,AMAL KUMAR DEYATI,Bharatiya Nyay-Adhikar Raksha Party,5445,6,5451,S2526
179,RAMESH KHANRA,Independent,5094,10,5104,S2526
180,BIMALESH KUMAR HELA,Bahujan Samaj Party,4867,8,4875,S2526
181,SK. SAPIYAR ALI,Independent,2924,0,2924,S2526
182,NIKHIL BERA,Socialist Unity Centre Of India (COMMUNIST),2095,12,2107,S2526
183,AMAL KUMAR BARMAN,Independent,1997,3,2000,S2526
184,RAMPRASAD GHORAI,Indian Unity Centre,1568,4,1572,S2526
185,NOTA,None of the Above,11263,55,11318,S2526
186,ANITA NAGARSINGH CHOUHAN,Bharatiya Janata Party,793432,2431,795863,S1224
187,KANTILAL BHURIA,Indian National Congress,586904,1727,588631,S1224
188,ENGINEER BALUSINGH GAMAD,Bharat Adivasi Party,52525,234,52759,S1224
189,RAMCHANDRA SOLANKI,Bahujan Samaj Party,15159,13,15172,S1224
190,SURAJ BHABHAR,Independent,10060,2,10062,S1224
191,RANGLA KALESH,Independent,7331,4,7335,S1224
192,KASNA RANA PARGI,Independent,7311,5,7316,S1224
193,SUMITRA MEDA,Independent,6927,3,6930,S1224
194,RAMESHWAR SINGAR,Independent,4603,4,4607,S1224
195,MOHANSINGH NINGWAL,Bhartiya Samajik Party,4503,4,4507,S1224
196,SHEETAL BARELA,Akhand Bharat Samrajya Party,3929,1,3930,S1224
197,UDESINGH MACHAR,Republican Party of India (A),3795,1,3796,S1224
198,NOTA,None of the Above,31697,38,31735,S1224
199,G. KISHAN REDDY,Bharatiya Janata Party,468311,4701,473012,S298
200,DANAM NAGENDER,Indian National Congress,420220,2848,423068,S298
201,PADMA RAO . T,Bharat Rashtra Samithi,128680,906,129586,S298
202,DR.  BASWANANDAM DANDEPU,Bahujan Samaj Party,2248,20,2268,S298
203,SARARAPU SRISAILAM,Telangana Rajya Samithi,1726,1,1727,S298
204,SAPAVAT SUMAN,Independent,996,0,996,S298
205,R.S.J. THOMAS,Jai Swaraj Party,971,3,974,S298
206,RAASALA VINOD KUMAR,Dharma Samaj Party,820,6,826,S298
207,KOLISETTY SHIVA KUMAR,Yuga Thulasi Party,678,1,679,S298
208,MACHCHERLA VENKATA REDDY,Independent,672,1,673,S298
209,MOHAMMED AKRAM ALI KHAN,Independent,596,1,597,S298
210,MOHAMMED RAFIUDDIN KALEEM,All India Majlis-E-Inquilab-E-Millat,478,6,484,S298
211,LUNAVATH HARI RAM,Independent,474,0,474,S298
212,BOGGULA SUNIITHHA,Independent,417,1,418,S298
213,MOHAMMED AYUB ALI,Anna YSR Congress Party,406,4,410,S298
214,MOHAMMED FASI UDDIN,Independent,341,1,342,S298
215,PULIMAMIDI VENKATESH GUPTA,Independent,340,0,340,S298
216,IBRAHIM KHAN,Independent,315,5,320,S298
217,ANDRAPU SUDARSHAN,Independent,312,3,315,S298
218,JUNAID ANAM SIDDIQUI,Independent,294,1,295,S298
219,KRANTHI KUMAR BANDELA,Indian National Yuva Jana Party,283,2,285,S298
220,DR. R. GANGADHAR,Socialist Unity Centre Of India (COMMUNIST),280,1,281,S298
221,UTTAM PRAVEEN KUMAR,Independent,273,1,274,S298
222,GOWLIKAR SONY,Social Justice Party of India,269,3,272,S298
223,BATHULA RAVI,Independent,252,0,252,S298
224,P C LINGANNA,Independent,243,0,243,S298
225,MOHAMMED IBRAHIM AHMED,Independent,240,2,242,S298
226,SANGALA FLORY,Independent,223,0,223,S298
227,MOHAMMED ABDUL AZEEM,Independent,220,1,221,S298
228,GANESH BHARGAVI GUNDE,Jai Bharat National Party,220,3,223,S298
229,V. K. VIJAYA LAKSHMI,Independent,213,3,216,S298
230,CHEEKATI BHUPAL GOUD,All India Backward People Sunami Party,209,1,210,S298
231,BOMMAKANTI SOWMYA,Pyramid Party of India,201,4,205,S298
232,KRUPAVARAM GANDU,Independent,159,2,161,S298
233,PAMPARI NARENDER,Independent,143,0,143,S298
234,SYED KHADER,Independent,132,1,133,S298
235,B . SUNITHA RANI,Socialist Party (India),130,3,133,S298
236,CHALIKA CHANDRA SEKHAR,Independent,129,0,129,S298
237,PAGIDIPALLI SHYAMSON,Viduthalai Chiruthaigal Katchi,126,4,130,S298
238,REDDYMALLA PARVATHI,Independent,126,1,127,S298
239,VELAMARTHI. RAVI KIRAN,Independent,123,1,124,S298
240,K. MURALI KRISHNA,Independent,120,0,120,S298
241,DEVENDAR KONNE,Independent,117,0,117,S298
242,KONDOJU MOHAN,Independent,113,1,114,S298
243,MD KHALEEL UZ ZAMA,Independent,110,1,111,S298
244,NOTA,None of the Above,5092,74,5166,S298
245,CHHATRAPATI SHAHU SHAHAJI,Indian National Congress,750323,4199,754522,S1347
246,SANJAY SADASHIVRAO MANDLIK,Shiv Sena,597014,2544,599558,S1347
247,SANJAY BHIKAJI MAGADE,Bahujan Samaj Party,3946,56,4002,S1347
248,MUSHTAK AJIJ MULLA,Independent,3822,2,3824,S1347
249,MADHURI RAJU JADHAV,Independent,3503,5,3508,S1347
250,KHADE BAJIRAO NANASO,Independent,3497,15,3512,S1347
251,KRUSHNABAI DIPAK CHOUGALE,Independent,3045,18,3063,S1347
252,KOGALE SANDEEP BHAIRAVNATH,Desh Janhit Party,2952,23,2975,S1347
253,ADV. YASH SUHAS HEGDEPATIL,Independent,2457,2,2459,S1347
254,NAGNATH PUNDALIK BENAKE,Independent,1215,12,1227,S1347
255,RAJANDARA BALASO KOLI,Independent,1029,15,1044,S1347
256,B. T. PATIL (EX SERVICEMAN),Bharatheeya Jawan Kisan Party,1011,96,1107,S1347
257,SUBHASH VAIJU DESAI,Independent,847,2,849,S1347
258,MANGESH JAYSINGH PATIL,Independent,647,6,653,S1347
259,SHASHIBHUSHAN JEEVANRAO DESAI,Akhil Bharat Hindu Mahasabha,636,15,651,S1347
260,SANTOSH GANPATI BISURE,Apni Prajahit Party,635,4,639,S1347
261,DR. SUNIL NAMDEV PATIL,National Black Panther Party,626,7,633,S1347
262,KRUSHNA HANMANT DESAI,Independent,602,2,604,S1347
263,IRFAN ABUTALIB CHAND,Independent,595,2,597,S1347
264,MANE ARVIND BHIVA,Bhartiya Rashtriya Dal,558,12,570,S1347
265,SANDEEP GUNDOPANT SANKPAL,Independent,541,3,544,S1347
266,KUDARTULLA ADAM LATIF,Independent,465,2,467,S1347
267,SALIM NURMUHAMAD BAGWAN,Independent,334,1,335,S1347
268,NOTA,None of the Above,5932,51,5983,S1347
269,RAMPRIT MANDAL,Janata Dal  (United),532138,894,533032,S047
270,SUMAN KUMAR MAHASETH,Vikassheel Insaan Party,347989,874,348863,S047
271,GULAB YADAV,Bahujan Samaj Party,73532,352,73884,S047
272,RAM PRASAD RAUT,Independent,25993,17,26010,S047
273,GANGA PRASAD YADAV,Independent,18064,10,18074,S047
274,GAURI SHANKAR SAHU,Independent,14307,18,14325,S047
275,RAJIV KUMAR JHA,Independent,12488,25,12513,S047
276,BABLU KUMAR,Aadarsh Mithila Party,11638,35,11673,S047
277,VIDYA NAND RAM,Wazib Adhikar Party,10843,19,10862,S047
278,VIJAY KUMAR MANDAL,Socialist Unity Centre Of India (COMMUNIST),8556,21,8577,S047
279,NOTA,None of the Above,35846,82,35928,S047
280,BAIJAYANT PANDA,Bharatiya Janata Party,612916,2789,615705,S1815
281,ANSHUMAN MOHANTY,Biju Janata Dal,547681,1488,549169,S1815
282,SIDHARTH SWARUP DASH,Indian National Congress,94595,237,94832,S1815
283,SOUBHAGYA KETAN SAMAL,Socialist Unity Centre Of India (COMMUNIST),3393,2,3395,S1815
284,SEKHA SADIKA HOSEN,Bahujan Samaj Party,1845,7,1852,S1815
285,SUPRAVA DAS,Akhil Bhartiya Parivar Party,1559,2,1561,S1815
286,SRIRAM PANDEY,Independent,1397,2,1399,S1815
287,SANTOSH KUMAR PATRA,Independent,1370,3,1373,S1815
288,PRATAP CHANDRA MOHANTY,Independent,1088,7,1095,S1815
289,PRANGYAN PRAKASH MOHAPATRA,Odisha Janata Party,910,2,912,S1815
290,NOTA,None of the Above,5807,8,5815,S1815
291,JAGADISH CHANDRA BARMA BASUNIA,All India Trinamool Congress,785747,2628,788375,S251
292,NISITH PRAMANIK,Bharatiya Janata Party,745144,3981,749125,S251
293,NITISH CHANDRA ROY,All India Forward Bloc,29992,275,30267,S251
294,PIYA ROY CHOWDHURY,Indian National Congress,10539,140,10679,S251
295,HAREKRISHNA SARKAR,Independent,9462,5,9467,S251
296,KAMALESH BARMAN,Independent,2972,21,2993,S251
297,NABI BARMAN,Independent,2710,14,2724,S251
298,SUBODH BARMAN,Independent,2594,5,2599,S251
299,DILIP CHANDRA BARMAN,Socialist Unity Centre Of India (COMMUNIST),2449,19,2468,S251
300,PURNA MOHAN ROY,Bahujan Samaj Party,2087,10,2097,S251
301,BIDHAN DAS,Independent,2067,5,2072,S251
302,KISHORE RAY,Independent,1588,18,1606,S251
303,PRADIP KUMAR ROY,Kamatapur People’s Party (United),1499,19,1518,S251
304,AMAL DAS,Independent,1488,7,1495,S251
305,NOTA,None of the Above,15510,53,15563,S251
306,KADIYAM KAVYA,Indian National Congress,575566,5728,581294,S2915
307,AROORI RAMESH,Bharatiya Janata Party,355875,5080,360955,S2915
308,Dr. MARAPALLY SUDHEER KUMAR,Bharat Rashtra Samithi,230820,1213,232033,S2915
309,AMBOJU BUDDAIAH,Alliance of Democratic Reforms Party,11103,12,11115,S2915
310,KALPANA PANJA,Bahujan Samaj Party,9230,97,9327,S2915
311,KONGARA ANIL KUMAR,Independent,6259,0,6259,S2915
312,ANIL KUMAR GADEPAKA,Independent,4482,4,4486,S2915
313,BUNGA JYOTHI RAMANA,Aihra National Party,4262,3,4265,S2915
314,MEKALA SUMAN,Dharma Samaj Party,3972,66,4038,S2915
315,AR NENA PREM READY RIPEEKA,Mana Telangana Rashtra Samaikya Party,3625,9,3634,S2915
316,KOYYADA NARESH,Independent,3283,3,3286,S2915
317,PRAMEELA JANNU,Independent,3022,0,3022,S2915
318,BARIGELA SHIVA,Independent,2947,2,2949,S2915
319,S P K  SAGAR,Jai Maha Bharath Party,2769,4,2773,S2915
320,PASULA RAVI,Republican Party of India (Athawale),2220,19,2239,S2915
321,DEVARAJU PENDELA,Rashtriya Praja Congress  (Secular),2072,11,2083,S2915
322,POTHARAJU NARASIMHARAJU,Independent,1955,0,1955,S2915
323,BOLLAM VIJAY KUMAR,Independent,1821,4,1825,S2915
324,MACHA DEVENDER,Viduthalai Chiruthaigal Katchi,1753,16,1769,S2915
325,ROOPA POLEPAKA,Independent,1657,2,1659,S2915
326,NARMADA PRAVEEN,Pyramid Party of India,1657,7,1664,S2915
327,DHAYAKAR GAJJI,Independent,1637,1,1638,S2915
328,POGULA ASHOK,Independent,1333,4,1337,S2915
329,THANDRA ESHWAR,Independent,1290,2,1292,S2915
330,MANDA NARESH,Independent,1044,7,1051,S2915
331,KOTHAPALLI SAVITHRI,Marxist Communist Party of India (United),1018,5,1023,S2915
332,PUTTA VINOD KUMAR,Independent,908,1,909,S2915
333,BOCHU RAJU,Independent,905,8,913,S2915
334,PAITHARA ACHYUTH,Independent,901,5,906,S2915
335,MANGALAPELLI ASHAIAH,Independent,847,0,847,S2915
336,GADDAM CHIRANJEEVI,Independent,825,1,826,S2915
337,MOTHKUPELLY PRABHAKAR,Independent,818,1,819,S2915
338,GANNARAPU RAVINDER,Independent,752,0,752,S2915
339,GANIPAKA PRADEEP,Independent,710,3,713,S2915
340,RAMESH BABU SHANIGARAPU,Independent,658,4,662,S2915
341,Dr GADAM MALLESH,Jai Bharat National Party,563,4,567,S2915
342,THALLAPALLY VENKATAIAH,Independent,538,0,538,S2915
343,BASHIPAKA SUDHAKAR,Independent,503,2,505,S2915
344,RK GANAPURAM,Independent,468,6,474,S2915
345,CHILUVERU PRATHAP,Independent,399,2,401,S2915
346,THATIKAYALA SATHISH BABU,Independent,382,2,384,S2915
347,CHILUMULLA SUJATHA,Independent,377,2,379,S2915
348,NOTA,None of the Above,8209,171,8380,S2915
349,KALI CHARAN SINGH,Bharatiya Janata Party,568912,5644,574556,S274
350,KRISHNA NAND TRIPATHI,Indian National Congress,348110,5487,353597,S274
351,AMIT KUMAR SINGH,Independent,31976,15,31991,S274
352,ARJUN KUMAR,Communist Party of India,14062,60,14122,S274
353,DR. ABHISHEK KUMAR SINGH,Independent,14038,68,14106,S274
354,ARJUN PRAJAPATI,Independent,13320,8,13328,S274
355,DEEPAK KUMAR GUPTA,Independent,12384,182,12566,S274
356,NAGMANI,Bahujan Samaj Party,11798,152,11950,S274
357,CHANDAN KUMAR,Independent,6569,13,6582,S274
358,MD ABUZAR KHAN,Independent,5820,3,5823,S274
359,YOGESH KUMAR SINGH,Independent,5110,2,5112,S274
360,BIMAL LAKRA,Ambedkarite Party of India,4983,31,5014,S274
361,KARMLAL ORAON,Peoples Party of India (Democratic),3968,42,4010,S274
362,SUMIT KUMAR YADAV,Samata Party,3499,17,3516,S274
363,SANJAY KUMAR SNEHI,Lokhit Adhikar Party,3202,14,3216,S274
364,MAHESH BANDO,Bahujan Mukti Party,3159,42,3201,S274
365,SRIRAM SINGH,Independent,2991,2,2993,S274
366,DARSHAN GANJHU,Jharkhand Party,2780,37,2817,S274
367,DULESHWAR SAW,Bharatheeya Jawan Kisan Party,2376,9,2385,S274
368,LAW KUMAR PANDIT,Bhagidari Party(P),2372,8,2380,S274
369,KAMDEO DIHO RANA,Rashtriya Jan Utkarsh Party,2297,12,2309,S274
370,VIKRANT KUMAR SINGH,Independent,2288,1,2289,S274
371,NOTA,None of the Above,8435,76,8511,S274
372,JAGANNATH SARKAR,Bharatiya Janata Party,778046,4350,782396,S2513
373,MUKUT MANI ADHIKARI,All India Trinamool Congress,592276,3221,595497,S2513
374,ALAKESH DAS,Communist Party of India  (Marxist),122970,840,123810,S2513
375,BIPLAB BISWAS,Bahujan Samaj Party,9319,73,9392,S2513
376,PARESH HALDAR,Socialist Unity Centre Of India (COMMUNIST),8223,16,8239,S2513
377,JAGANNATH SARKAR,Independent,5831,30,5861,S2513
378,SHYAMAL KUMAR MALLICK,Independent,5533,11,5544,S2513
379,NOTA,None of the Above,9798,95,9893,S2513
380,THARANIVENTHAN M S,Dravida Munnetra Kazhagam,497083,3016,500099,S2212
381,"GAJENDRAN, G.V.",All India Anna Dravida Munnetra Kazhagam,289650,1683,291333,S2212
382,DR GANESH KUMAR A ME PHD,Pattali Makkal Katchi,234538,2033,236571,S2212
383,"BAKIYALAKSHMI, K.",Naam Tamilar Katchi,65981,759,66740,S2212
384,"MANIGANDAN, V.",Independent,4787,21,4808,S2212
385,"GANESH KUMAR, U.",Independent,3809,3,3812,S2212
386,DURAI  M,Bahujan Samaj Party,3635,50,3685,S2212
387,"GAJENDRAN, J.",Independent,3393,7,3400,S2212
388,"KARVANNAN, K.",Independent,3032,4,3036,S2212
389,"GAJENDIRAN, E.",Independent,2612,1,2613,S2212
390,"KOTTAI VENKATESAN, M.",Independent,1893,15,1908,S2212
391,"SENTHIL KUMAR, D.",Independent,1469,6,1475,S2212
392,"SEKAR, N.",Independent,1397,3,1400,S2212
393,SAKTHIVEL A,Thakkam Katchi,1174,12,1186,S2212
394,"GANESH, P.",Independent,978,2,980,S2212
395,NAGARAJAN P,Veerath Thiyagi Viswanathadoss Thozhilalarkal Katchi,921,6,927,S2212
396,CAPTAIN SETTU M,Viro Ke Vir Indian Party,881,41,922,S2212
397,"JAISANKAR, M.",Independent,836,4,840,S2212
398,EZHIL ARASU M,Independent,741,12,753,S2212
399,BABU N,Independent,669,5,674,S2212
400,"DURUGAN, M.",United Republican Party of India,596,8,604,S2212
401,MOHMMAD SIDDIQ M H,Independent,525,3,528,S2212
402,"DHARANI, D.",Independent,466,2,468,S2212
403,"MANAVALAN, A.",Anna MGR Dravida Makkal Kalgam,433,47,480,S2212
404,"ARUL, M.",Independent,429,81,510,S2212
405,"MURUGESAN, D.",Independent,398,5,403,S2212
406,"ELLAPPAN, R.",Independent,375,3,378,S2212
407,"FEROZKHAN, A.",Independent,295,3,298,S2212
408,"DHAMODHARAN, G.",Independent,237,5,242,S2212
409,NOTA,None of the Above,9084,104,9188,S2212
410,NARESH GANPAT MHASKE,Shiv Sena,732109,2122,734231,S1325
411,RAJAN BABURAO VICHARE,Shiv Sena (Uddhav Balasaheb Thackrey),515013,2207,517220,S1325
412,SANTOSH BHIKAJI BHALERAO,Bahujan Samaj Party,10602,60,10662,S1325
413,ADV. GURUDEV NARSINGH SURYAWANSHI,Independent,3489,5,3494,S1325
414,MUKESH KAILASNATH TIWARI,Bhim Sena,2509,13,2522,S1325
415,JHA SUBHASH CHANDRA,Sardar Vallabhbhai Patel Party,2354,4,2358,S1325
416,DR. PIYUSH K. SAXENA,Independent,2292,1,2293,S1325
417,CHANDRAKANT VITTHAL SONAWANE,Independent,2245,4,2249,S1325
418,VIJAY DNYANOBA GHATE,Republican Bahujan Sena,1870,17,1887,S1325
419,IRFAN IBRAHIM SHAIKH,Independent,1867,8,1875,S1325
420,PRAMOD ANANDRAO DHUMAL,Independent,1785,1,1786,S1325
421,BHANWARLAL KHETMAL MEHTA,Hindu Samaj Party,1483,5,1488,S1325
422,UTTAM KISANRAO TIRPUDE,Peoples Party of India (Democratic),1349,5,1354,S1325
423,ARCHANA DINKAR GAIKWAD,Independent,1164,16,1180,S1325
424,SALIMA MUKTAR VASANI,Bahujan Maha Party,905,7,912,S1325
425,RAJIV KONDIBA BHOSALE,Independent,878,8,886,S1325
426,RAHUL JAGBIRSINGH MEHAROLIYA,Bahujan Republican  Socialist Party,818,0,818,S1325
427,RAJENDRA RAMCHANDRA SANKHE,Bharatheeya Jawan Kisan Party,759,8,767,S1325
428,KHAJASAB RASULSAB MULLA,Independent,646,2,648,S1325
429,SANJAY MANOHAR MORE,Independent,639,4,643,S1325
430,MALLIKARJUN SAYBANNA PUJARI,Independent,597,2,599,S1325
431,SAWALE DATTATRAY SITARAM,Independent,529,2,531,S1325
432,SURENDRAKUMAR K. JAIN,Independent,438,2,440,S1325
433,SIDDHANT CHHABAN SHIRSAT,Independent,319,5,324,S1325
434,NOTA,None of the Above,17768,133,17901,S1325
435,SACHITHANANTHAM R,Communist Party of India  (Marxist),667391,2758,670149,S2222
436,MOHAMED MUBARAK M A,All India Anna Dravida Munnetra Kazhagam,225492,836,226328,S2222
437,THILGABAMA M,Pattali Makkal Katchi,111013,1490,112503,S2222
438,KAILAI RAJAN D,Naam Tamilar Katchi,96891,954,97845,S2222
439,RAJKUMAR R,Independent,4410,6,4416,S2222
440,NATCHIMUTHU S,Bahujan Samaj Party,4231,53,4284,S2222
441,DINESHKUMAR S,All India Youth Development Party,2411,23,2434,S2222
442,MURUGESAN (A) VISHNU MURUGESAN C,Independent,2004,4,2008,S2222
443,ANGUCHAMY M,Independent,1286,4,1290,S2222
444,SURESH K,Independent,1254,3,1257,S2222
445,ARUMUGAM R,Independent,1078,11,1089,S2222
446,SABARINATH S,Independent,1001,10,1011,S2222
447,ANBUROSE D,Independent,997,15,1012,S2222
448,PALANISAMY K,Independent,941,8,949,S2222
449,SATHISH KANNA G T,Independent,914,12,926,S2222
450,NOTA,None of the Above,21860,260,22120,S2222
451,DEVESH SHAKYA,Samajwadi Party,474263,1545,475808,S2422
452,RAJVEER SINGH (RAJU BHAIYA),Bharatiya Janata Party,446748,1008,447756,S2422
453,MOHAMMAD IRFAN ADVOCATE,Bahujan Samaj Party,71407,178,71585,S2422
454,ANUPAM KUMAR,Kisan Kranti Dal,3944,5,3949,S2422
455,KAILASH KUMAR,Independent,1728,0,1728,S2422
456,DANVEER,Independent,1261,4,1265,S2422
457,UDAY VEER SINGH,Peoples Party of India (Democratic),985,7,992,S2422
458,ASHOK KUMAR,Independent,777,3,780,S2422
459,VIABHAV MISHRA,Bhartiya Shakti Chetna Party,742,5,747,S2422
460,AMAR SINGH,Independent,609,6,615,S2422
461,NOTA,None of the Above,5145,11,5156,S2422
462,DR.MALLU RAVI,Indian National Congress,459259,5813,465072,S2912
463,BHARATH  PRASAD POTHUGANTI,Bharatiya Janata Party,364898,5760,370658,S2912
464,DR.R.S.PRAVEEN KUMAR,Bharat Rashtra Samithi,319216,2127,321343,S2912
465,AMBOJU RAVI,Alliance of Democratic Reforms Party,12544,10,12554,S2912
466,BESAMOLLA  YOSEF,Bahujan Samaj Party,7138,80,7218,S2912
467,PILLELA SRIKANTH,Independent,6403,1,6404,S2912
468,BUDDHULA SRINIVAS,Independent,4358,3,4361,S2912
469,PALADHI NAGARAJU,Independent,4056,2,4058,S2912
470,AMARNATH,India Praja Bandhu Party,3703,6,3709,S2912
471,PULJALA BALAIAH,Independent,3582,2,3584,S2912
472,GALIMUDI GEETHA,Independent,3145,2,3147,S2912
473,KARNE. SHIREESHA @ BARRELAKKA,Independent,3037,50,3087,S2912
474,PAKIRA RAMULU,Independent,2833,6,2839,S2912
475,BIKSHAPATHI LANDA,Independent,1980,1,1981,S2912
476,AYYAPPA SUNIL,Rashtriya Praja Congress  (Secular),1224,3,1227,S2912
477,GADDAM VIJAY,Bahujan Mukti Party,1006,3,1009,S2912
478,PRASANGI,Pyramid Party of India,892,0,892,S2912
479,VAGGU VINAY,Vidhyarthula Rajakiya Party,768,2,770,S2912
480,DASARI BHARATHI,Viduthalai Chiruthaigal Katchi,722,8,730,S2912
481,NOTA,None of the Above,4511,69,4580,S2912
482,DR SHRIKANT EKNATH SHINDE,Shiv Sena,587921,1715,589636,S1324
483,VAISHALI DAREKAR - RANE,Shiv Sena (Uddhav Balasaheb Thackrey),379236,1256,380492,S1324
484,MO. SAHABUDDIN SHAIKH SULEMANI THAKUR,Vanchit Bahujan  Aaghadi,18697,44,18741,S1324
485,PRASHANT RAMESH INGLE,Bahujan Samaj Party,11285,56,11341,S1324
486,AMIT UPADHYAY,Right to Recall Party,4185,20,4205,S1324
487,ARUN BHAURAO NITURE,Rashtriya Kisan Bahujan Party,2751,2,2753,S1324
488,AMRISH RAJ MORAJKAR,Independent,2616,4,2620,S1324
489,ASHWINI AMOL KENDRE,Independent,2461,7,2468,S1324
490,NAFIS AHMED ANSARI,Independent,1997,3,2000,S1324
491,SUSHILA KASHINATH KAMBLE,Bahujan Samaj Party  (Ambedkar),1847,11,1858,S1324
492,ABHIJIT WAMANRAO BICHUKALE,Independent,1823,1,1824,S1324
493,AJAY SHYAM MORYA,Independent,1798,4,1802,S1324
494,SAMBHAJI JAGANNATH JADHAV,Sanyukt Bharat Paksh,1607,2,1609,S1324
495,CHANDRAKANT RAMBHAJI MOTE,Independent,1378,2,1380,S1324
496,POONAM JAGANNATH BAISANE,Bahujan Republican  Socialist Party,1376,5,1381,S1324
497,HINDURAO DADU PATIL,Rashtriya Maratha Party,1236,7,1243,S1324
498,GAWALI PRAVIN SHIVAJI,Apni Prajahit Party,1080,2,1082,S1324
499,ARUN VAMAN JADHAV,Independent,1077,5,1082,S1324
500,SHRIDHAR NARAYAN SALVE,Bhim Sena,1068,4,1072,S1324
501,SHRIKANT SHIVAJI VANJARE,Peoples Party of India (Democratic),806,2,808,S1324
502,PRAJAKTA NILESH YELVE,Independent,780,3,783,S1324
503,DNYANESHWAR LOKHANDE MAHARAJ,Independent,738,3,741,S1324
504,ADV. HITESH JAIKISHAN JESWANI,Independent,712,3,715,S1324
505,MOHAMMAD YUSUF KHAN,Independent,648,5,653,S1324
506,RAKESH KUMAR DHISULAL JAIN,Independent,599,3,602,S1324
507,SHIVA KRISHNAMURTI IYER,Independent,435,2,437,S1324
508,SALIMUDDIN KHALILUDDIN SHAIKH,Independent,370,1,371,S1324
509,DR. SACHIN SAHEBRAO PATIL,Independent,346,5,351,S1324
510,NOTA,None of the Above,11603,83,11686,S1324
511,BHAJAN LAL JATAV,Indian National Congress,525379,4632,530011,S2010
512,INDU DEVI,Bharatiya Janata Party,426798,4268,431066,S2010
513,VIKRAM SINGH,Bahujan Samaj Party,14005,107,14112,S2010
514,RAMKHILADI DHOVI,Independent,5426,47,5473,S2010
515,NOTA,None of the Above,7402,58,7460,S2010
516,SHATRUGHAN PRASAD SINHA,All India Trinamool Congress,603105,2540,605645,S2540
517,SURENDRAJEET SINGH AHLUWALIA,Bharatiya Janata Party,544077,2004,546081,S2540
518,JAHANARA KHAN,Communist Party of India  (Marxist),105454,510,105964,S2540
519,DIPIKA BAURI,Independent,10623,24,10647,S2540
520,SUNNY KUMAR SAH,Bahujan Samaj Party,8546,29,8575,S2540
521,SUJIT PAL,Independent,4749,11,4760,S2540
522,AMARNATH CHOWDHURY,Socialist Unity Centre Of India (COMMUNIST),4330,28,4358,S2540
523,NOTA,None of the Above,15448,62,15510,S2540
524,DUSHYANT SINGH,Bharatiya Janata Party,861850,3526,865376,S2025
525,URMILA JAIN “BHAYA”,Indian National Congress,492342,2045,494387,S2025
526,CHANDRA SINGH KIRAD,Bahujan Samaj Party,12252,33,12285,S2025
527,RAVI RAJ SINGH,Independent,10231,43,10274,S2025
528,BHUVANESH KUMAR,Right to Recall Party,9324,21,9345,S2025
529,BABULAL,Independent,7668,24,7692,S2025
530,PANKAJ PAJANTORIVALA,Independent,5927,18,5945,S2025
531,NOTA,None of the Above,15958,69,16027,S2025
532,ANNPURNA DEVI,Bharatiya Janata Party,787185,4472,791657,S275
533,VINOD KUMAR SINGH,Communist Party of India  (Marxist-Leninist)  (Liberation),410945,3698,414643,S275
534,MANOJ KUMAR,Independent,28310,302,28612,S275
535,JAI PRAKASH VERMA,Independent,22843,380,23223,S275
536,SITAN RABIDAS,Bahujan Samaj Party,13067,107,13174,S275
537,SURENDRA KUMAR AGRAWAL,Independent,9646,10,9656,S275
538,SAHADAT ANSARI,Independent,8217,15,8232,S275
539,JAYNARAYAN DAS,Bahujan Mukti Party,6701,37,6738,S275
540,AKLESHWAR SAW,Lokhit Adhikar Party,5574,27,5601,S275
541,JITLAL KISKU,Independent,5299,34,5333,S275
542,MD. SAGIR,Independent,5041,3,5044,S275
543,AJAY KRISHNA,Moolniwasi Samaj Party,4526,15,4541,S275
544,RAJESH,Independent,4230,3,4233,S275
545,RAMESHWAR PRASAD YADAV,Independent,4227,2,4229,S275
546,ASHISH KUMAR,Right to Recall Party,2892,4,2896,S275
547,NOTA,None of the Above,42089,63,42152,S275
548,BALWANT BASWANT WANKHADE,Indian National Congress,524136,2135,526271,S137
549,NAVNEET RAVI RANA,Bharatiya Janata Party,504806,1734,506540,S137
550,DINESH GANESHDAS BUB,Prahar Janshakti Party,84985,315,85300,S137
551,ANANDRAJ YASHWANT AMBEDKAR,Republican Sena,18713,80,18793,S137
552,KISHOR BHIMRAO LABADE,Independent,4522,2,4524,S137
553,SANJAYKUMAR FATTESINGH GADGE,Bahujan Samaj Party,4485,28,4513,S137
554,SUMITRA SAHEBRAO GAIKWAD,Independent,2686,4,2690,S137
555,ARUN YASHWANTRAO BHAGAT,Independent,2086,2,2088,S137
556,KISHOR DNYANESHWAR TAYDE,Independent,2070,2,2072,S137
557,SURAJ DHANRAJ NAGDVANE,Independent,1815,3,1818,S137
558,GAUTAM ALIAS ANANTA RAMDAS INGALE,Independent,1570,0,1570,S137
559,PRAMOD RAMKRUSHNA CHOURPAGAR,Independent,1306,1,1307,S137
560,ANIL THAWARE ALIAS DR. ANILKUMAR NAGBUDDHA,Independent,1206,0,1206,S137
561,SURESH PUNDLIK MESHRAM,Independent,1051,1,1052,S137
562,SATISH YASHWANTRAO GEDAM,Independent,942,1,943,S137
563,MANOHAR KRUSHNAJI KURHADE,Independent,871,0,871,S137
564,DIGAMBAR WAMAN BHAGAT,Naki Bharatiya Ekta Party,760,2,762,S137
565,ENGI. AVINASH HARISHCHANDRA DHANAWATE,Peoples Party of India (Democratic),725,5,730,S137
566,HIMMAT BHIMRAO DHOLE,Independent,668,2,670,S137
567,SUSHAMA GAJANAN AWACHAR,Jay Vidarbha Party,656,3,659,S137
568,GANESH NANAJI RAMTEKE,Akhil Bhartiya Parivar Party,624,5,629,S137
569,MANKAR DNYANESHWAR KASHIRAO,Independent,538,1,539,S137
570,TARA SURESH WANKHADE,Independent,526,1,527,S137
571,SHRIKRUSHNA SAKHARAMJI KSHIRSAGAR,Independent,508,2,510,S137
572,ADV. RAJU MADHUKARRAO KALANE,Bahujan Bharat Party,495,0,495,S137
573,BHARAT CHAMPATRAO YANGAD,Independent,441,0,441,S137
574,VARSHA BHAGAWANTRAO BHAGAT,Independent,440,3,443,S137
575,NARENDRA BABULAL KATHANE,Desh Janhit Party,422,0,422,S137
576,PRABHAKAR PANDURANG BHATKAR,Independent,365,0,365,S137
577,ADV. PRUTHVISAMRAT MUKINDRAO DIPWANSH,Independent,335,2,337,S137
578,BHAURAO SAMPATRAO WANKHADE,All India Forward Bloc,328,1,329,S137
579,GHAZI SAADUDDIN ZAHEER AHMED,Rashtriya Ulama Council,325,6,331,S137
580,RAVI GUNWANTRAO WANKHADE,Independent,286,2,288,S137
581,SONALI SANJAY MESHRAM,Independent,270,2,272,S137
582,SANDEEP BABULAL MESHRAM,Independent,257,0,257,S137
583,RAJESH TULSHIRAM KHADE,Independent,239,0,239,S137
584,RAJU MAHADEVRAO SONONE,Independent,230,2,232,S137
585,NOTA,None of the Above,2517,27,2544,S137
586,AJENDRA SINGH LODHI,Samajwadi Party,490003,680,490683,S2447
587,KUNWAR PUSHPENDRA SINGH CHANDEL,Bharatiya Janata Party,487373,681,488054,S2447
588,NIRDOSH KUMAR DIXIT,Bahujan Samaj Party,94564,132,94696,S2447
589,ANUPAM KUMAR TRIPATHI,Bhartiya Shakti Chetna Party,6401,6,6407,S2447
590,BRIJESH KUMAR PAL,Rashtra Uday Party,4516,11,4527,S2447
591,BHUVANENDRA NARAYAN SINGH,Independent,4315,5,4320,S2447
592,SANTOSH KUMAR,Independent,3776,1,3777,S2447
593,RAJESH SINGH,Independent,3605,2,3607,S2447
594,SURESH KUMAR,Eklavya Samaj Party,2181,0,2181,S2447
595,SANJIV KUMAR,Spashtwadi Jan Aadhar Party,2003,0,2003,S2447
596,DHARMRAJ,Al-Hind Party,1589,2,1591,S2447
597,NOTA,None of the Above,13442,11,13453,S2447
598,PARBHUBHAI NAGARBHAI VASAVA,Bharatiya Janata Party,757787,6163,763950,S0623
599,CHAUDHARY SIDDHARTH AMARSINH,Indian National Congress,526054,7643,533697,S0623
600,REKHABEN HARSINGBHAI CHAUDHARI,Bahujan Samaj Party,15872,272,16144,S0623
601,NOTA,None of the Above,24762,780,25542,S0623
602,ANTO ANTONY,Indian National Congress,360957,6666,367623,S1117
603,DR.T.M.THOMAS ISSAC,Communist Party of India  (Marxist),297888,3616,301504,S1117
604,ANIL K.ANTONY,Bharatiya Janata Party,231172,3234,234406,S1117
605,ADV.P.K.GEETHAKRISHNAN,Bahujan Samaj Party,3918,54,3972,S1117
606,JOY P.MATHEW,People's Party of India(secular),1173,8,1181,S1117
607,K.C.THOMAS,Independent,1080,21,1101,S1117
608,ADV.HARIKUMAR M.K.,Ambedkarite Party of India,735,27,762,S1117
609,ANOOP V.,Independent,557,52,609,S1117
610,NOTA,None of the Above,8268,143,8411,S1117
611,LAXMIKANT PAPPU NISHAD,Samajwadi Party,497488,1207,498695,S2462
612,PRAVIN KUMAR NISHAD,Bharatiya Janata Party,405611,914,406525,S2462
613,NADEEM ASHRAF,Bahujan Samaj Party,150549,263,150812,S2462
614,DHEERAJ SRIVASTAV,Pragatisheel Samaj Party,5135,5,5140,S2462
615,RAM KRISHNA DWIVEDI,Independent,4509,0,4509,S2462
616,SATYVANT PRATAP SINGH,Independent,4351,7,4358,S2462
617,KULDEEP,Sardar Patel Siddhant Party,3591,4,3595,S2462
618,MITRASEN,Independent,2535,9,2544,S2462
619,RAJENDRA YADAV URF COLONEL SAHAB,Sarvjan Awaz Party,2229,10,2239,S2462
620,ANAND KUMAR GAUTAM,Independent,1840,10,1850,S2462
621,SUBHASH CHANDRA DUBEY,Naki Bharatiya Ekta Party,1702,6,1708,S2462
622,NOTA,None of the Above,9210,17,9227,S2462
623,DM KATHIR ANAND,Dravida Munnetra Kazhagam,566435,2257,568692,S228
624,AC SHANMUGAM,Bharatiya Janata Party,350956,2034,352990,S228
625,DR S PASUPATHI,All India Anna Dravida Munnetra Kazhagam,116964,718,117682,S228
626,D MAHESH ANAND,Naam Tamilar Katchi,52707,577,53284,S228
627,A NATARAJAN,Bharatiya Praja Aikyata Party,3982,23,4005,S228
628,SHANMUGAVELU,Independent,3570,6,3576,S228
629,MANSOOR ALI KHAN,Independent,2769,35,2804,S228
630,SYED ALI D,Independent,2121,3,2124,S228
631,P SHANMUGAM,Independent,2037,2,2039,S228
632,NAGARAJ P,Independent,1948,11,1959,S228
633,K JAYAMANI,Bahujan Samaj Party,1684,18,1702,S228
634,D SARAVANAN,Independent,1497,0,1497,S228
635,MP SHANMUGAM,Independent,859,9,868,S228
636,N SIVAKUMAR,Independent,701,0,701,S228
637,AFROSE,Independent,672,1,673,S228
638,A BEEMARAO MILINTHAR,United Republican Party of India,667,3,670,S228
639,DR S JAYARAJ,Independent,659,2,661,S228
640,K SHANMUGAM,Independent,601,15,616,S228
641,V KALIAPERUMAL,Ganasangam Party of India,594,6,600,S228
642,G SHANMUGAM,Independent,560,12,572,S228
643,PP JAYAPRAKASH,Independent,455,6,461,S228
644,PASUPATHI,Independent,407,8,415,S228
645,S WILLIAM SATHYARAJ,Tamil Manila Murpokku Dravida Kazhagam,373,4,377,S228
646,M BABU,Independent,303,3,306,S228
647,B JAGAN,Independent,282,3,285,S228
648,AHMED RAASHID PALLIMIRA,Independent,271,2,273,S228
649,SHANMUGASUNDARAM,Independent,250,1,251,S228
650,C MADHAVAN,Independent,201,1,202,S228
651,T JOHNSON,Independent,174,0,174,S228
652,E RAJKUMAR,Independent,129,4,133,S228
653,C RAMACHANDHIRAN,Independent,128,2,130,S228
654,NOTA,None of the Above,8669,67,8736,S228
655,ASIT KUMAR MAL,All India Trinamool Congress,851209,4424,855633,S2541
656,PIYA SAHA,Bharatiya Janata Party,525463,2917,528380,S2541
657,SHYAMALI PRADHAN,Communist Party of India  (Marxist),98819,564,99383,S2541
658,ATUL CHANDRA BAURI,Independent,7811,18,7829,S2541
659,DR MANIK CHANDRA PRODHAN,Bahujan Samaj Party,7011,28,7039,S2541
660,SHANTA DAS,Mulnibasi Party of India,3633,7,3640,S2541
661,BIJOY DOLUI,Socialist Unity Centre Of India (COMMUNIST),2774,18,2792,S2541
662,MANTU DHIBAR,Hindustan Shakti Sena,2048,4,2052,S2541
663,NOTA,None of the Above,21640,82,21722,S2541
664,AZAD KIRTI JHA,All India Trinamool Congress,717069,3598,720667,S2539
665,DILIP GHOSH,Bharatiya Janata Party,579609,3077,582686,S2539
666,SUKRITI GHOSAL,Communist Party of India  (Marxist),152851,978,153829,S2539
667,LUXMI NARAYAN KORA,Independent,7138,4,7142,S2539
668,PRABHU NATH SAH,Bahujan Samaj Party,6822,34,6856,S2539
669,TASBIRUL ISLAM,Socialist Unity Centre Of India (COMMUNIST),3450,19,3469,S2539
670,REENA LEONG,Independent,3100,11,3111,S2539
671,MIR SAKIMUDDIN,The National Road Map Party of India,2413,5,2418,S2539
672,NOTA,None of the Above,21532,63,21595,S2539
673,KHAGEN MURMU,Bharatiya Janata Party,525109,1914,527023,S257
674,PRASUN BANERJEE,All India Trinamool Congress,448234,1081,449315,S257
675,ALAM MOSTAQUE,Indian National Congress,384063,701,384764,S257
676,JATISH KISKU,Independent,8680,3,8683,S257
677,MONATAN HEMBRAM,Independent,7927,6,7933,S257
678,SWAPAN MAHATO,Independent,7235,2,7237,S257
679,SANATAN RISHI,Bahujan Samaj Party,5624,8,5632,S257
680,JOSEPH KISKU,Ambedkarite Party of India,4637,0,4637,S257
681,MONJU HEMBROM,Independent,3535,3,3538,S257
682,MD FARUQUE HOSSAIN,Independent,3374,1,3375,S257
683,SOMNATH DAS,Bharatiya Nyay-Adhikar Raksha Party,3157,7,3164,S257
684,SUBHASH BARMAN,Kamatapur People’s Party (United),2019,0,2019,S257
685,KALICHARAN ROY,Socialist Unity Centre Of India (COMMUNIST),1286,7,1293,S257
686,MD SOHEL,All India Secular Front,1090,2,1092,S257
687,NARESH PAL,Jan Sangh Party,593,3,596,S257
688,NOTA,None of the Above,7257,31,7288,S257
689,VISHAL (DADA) PRAKASHBAPU PATIL,Independent,569651,2015,571666,S1344
690,SANJAY (KAKA) PATIL,Bharatiya Janata Party,469392,2221,471613,S1344
691,CHANDRAHAR SUBHASH PATIL,Shiv Sena (Uddhav Balasaheb Thackrey),60115,745,60860,S1344
692,ALLAUDDIN HAYATCHAND KAZI,Independent,9269,13,9282,S1344
693,PRAKASH SHIVAJIRAO SHENDGE,Independent,8150,101,8251,S1344
694,PANDURANG RAOSAHEB BHOSALE,Bharatheeya Jawan Kisan Party,5518,47,5565,S1344
695,TIPUSULATAN SIKANDAR PATAVEGAR,Bahujan Samaj Party,5502,58,5560,S1344
696,MAHESH YASHWANT KHARADE,Swabhimani Paksha,5491,30,5521,S1344
697,RAVINDRA CHANDAR SOLANKAR,Independent,3649,9,3658,S1344
698,ANAND SHANKAR NALAGE,Baliraja Party,3531,9,3540,S1344
699,SHASHIKANT GAUTAM DESHMUKH,Independent,3143,12,3155,S1344
700,SATISH LALITA KRISHNA KADAM,Hindustan Janta Party,2851,8,2859,S1344
701,SUWARNATAI SUDHAKAR GAYAKWAD,Independent,1925,12,1937,S1344
702,DATTATRAY PANDIT PATIL,Independent,1468,1,1469,S1344
703,TOUHID ILAHI MOMIN,Independent,1460,0,1460,S1344
704,AJIT DHANAJI KHANDARE,Independent,1380,18,1398,S1344
705,BANDAGAR NANASO BALASO,Independent,1292,8,1300,S1344
706,JALINDAR MACHINDRA THOMAKE,Independent,1257,3,1260,S1344
707,SANGRAM RAJARAM MORE,Independent,1004,7,1011,S1344
708,DR AKASH VHATKAR,Independent,803,11,814,S1344
709,NOTA,None of the Above,6512,53,6565,S1344
710,SHIV PAL SINGH PATEL (DR. S P SINGH),Samajwadi Party,439836,2096,441932,S2439
711,SANGAM LAL GUPTA,Bharatiya Janata Party,374208,1518,375726,S2439
712,PRATHMESH MISHRA 'SENANI',Bahujan Samaj Party,79872,272,80144,S2439
713,SANDEEP SINGH,National Jan Dal,5270,16,5286,S2439
714,ARUN KUMAR PANDEY,Hindustan Samaj Party,4984,7,4991,S2439
715,SHIV RAM SHARMA,Moulik Adhikar Party,4709,2,4711,S2439
716,AMAR SINGH,Independent,4135,3,4138,S2439
717,SUNIL CHANDRA PAL,Rashtra Uday Party,3337,3,3340,S2439
718,AJEET PRATAP,Independent,2581,0,2581,S2439
719,VIJAY SINGH,Sanatan Sanskriti Raksha Dal,2457,2,2459,S2439
720,RISHI PATEL,Apna Dal (Kamerawadi),2425,4,2429,S2439
721,MAHESH KUMAR PRAJAPATI,Samajhdar Party,1963,1,1964,S2439
722,DHANANJAY,Independent,1622,1,1623,S2439
723,GEETA DEVI,Bhartiya Lokmat Rashtrwadi Party,1582,12,1594,S2439
724,RAMSIDDH YADAV URF R.S.YADAV,Manavtawadi Samaj Party,1326,1,1327,S2439
725,SUNIL KUMAR MISHRA,Independent,1134,2,1136,S2439
726,SHANKAR SUMAN TIVARI,Independent,1128,1,1129,S2439
727,DURGESH KUMAR,Rastriya Atal Janta Party,1113,3,1116,S2439
728,RAM KUMAR YADAV,Socialist Unity Centre Of India (COMMUNIST),1070,1,1071,S2439
729,SHIV PAL PATEL,Independent,1025,5,1030,S2439
730,DHARMENDRA TIWARI,Log Party,992,1,993,S2439
731,JOKHU PATEL,Sardar Patel Siddhant Party,969,2,971,S2439
732,SHRAWAN KUMAR TRIPATHI,Independent,849,2,851,S2439
733,DHYAN SINGH,Independent,675,3,678,S2439
734,PRAMOD KUMAR,Independent,672,2,674,S2439
735,MOHRAM ALI,Independent,501,2,503,S2439
736,NOTA,None of the Above,2869,22,2891,S2439
737,LUMBARAM,Bharatiya Janata Party,793705,3078,796783,S2018
738,VAIBHAV GEHLOT,Indian National Congress,592204,3036,595240,S2018
739,OTARAM,Bharat Adivasi Party,10077,32,10109,S2018
740,SHAKUR,Independent,9866,6,9872,S2018
741,MOTI LAL,Aazad Samaj Party (Kanshi Ram),4579,7,4586,S2018
742,RAMESH KUMAR BHANDARI,Independent,3909,1,3910,S2018
743,DEVARAM,Independent,3126,8,3134,S2018
744,KALURAM MEGHWAL,Independent,2258,5,2263,S2018
745,DINESH SINGH,Independent,2094,11,2105,S2018
746,TIKMA RAM BHATI,Bheem Tribal Congress,1653,7,1660,S2018
747,DALARAM,Independent,1493,15,1508,S2018
748,FOJARAM,Indian Peoples Green Party,1493,4,1497,S2018
749,NOTA,None of the Above,18439,20,18459,S2018
750,GURMEET SINGH MEET HAYER,Aam Aadmi Party,362791,1294,364085,S1912
751,SUKHPAL SINGH KHAIRA,Indian National Congress,190209,1316,191525,S1912
752,SIMRANJIT SINGH MANN,Shiromani Akali Dal (Amritsar)(Simranjit Singh Mann),186543,703,187246,S1912
753,ARVIND KHANNA,Bharatiya Janata Party,127781,472,128253,S1912
754,IQBAL SINGH JHUNDAN,Shiromani Akali Dal,62265,223,62488,S1912
755,MAKHAN SINGH,Bahujan Samaj Party,37604,127,37731,S1912
756,PARDEEP KUMAR,Apni Ekta Party,5131,8,5139,S1912
757,HARBHAJAN SINGH,Aazad Samaj Party (Kanshi Ram),3417,14,3431,S1912
758,SUKHWINDER SINGH,Independent,3225,0,3225,S1912
759,BALWINDER SINGH SEKHON,Independent,2562,10,2572,S1912
760,BALWINDER SINGH,Independent,2284,4,2288,S1912
761,JASWANT SINGH,Independent,2222,2,2224,S1912
762,PAPPU KUMAR,Independent,1826,1,1827,S1912
763,KRISHAN DEV,Punjab National Party,1803,12,1815,S1912
764,AMANPREET SINGH,Independent,1686,7,1693,S1912
765,RANGI KHAN,Aam Janta Party (India),1578,3,1581,S1912
766,JILE SINGH,Bhartiya Jan Samman Party,1546,2,1548,S1912
767,KAMAL KUMAR VERMA (BHASAUR),"Adarsh Janta Party,",1376,0,1376,S1912
768,CHANNVEER SINGH,Independent,1281,2,1283,S1912
769,JAGTAR SINGH,Nationalist Justice Party,1224,1,1225,S1912
770,VIJAY SYAL,Independent,1144,1,1145,S1912
771,HARPREET KAUR,India Greens Party,1095,10,1105,S1912
772,RAJA SINGH,Independent,1037,3,1040,S1912
773,NOTA,None of the Above,3773,47,3820,S1912
774,ARUN NEHRU,Dravida Munnetra Kazhagam,598003,5206,603209,S2225
775,CHANDRAMOHAN N D,All India Anna Dravida Munnetra Kazhagam,212495,1607,214102,S2225
776,PAARIVENDHAR T R,Bharatiya Janata Party,160606,1260,161866,S2225
777,THENMOZHI R,Naam Tamilar Katchi,112200,892,113092,S2225
778,MANI S,Independent,3950,1,3951,S2225
779,MADHU R,Independent,3498,10,3508,S2225
780,RENGARAJ S,Independent,3251,22,3273,S2225
781,ELANGOVAN R,Bahujan Samaj Party,3033,26,3059,S2225
782,VASUDEVAN A,Independent,1355,7,1362,S2225
783,ARUN NEHRU,Independent,1280,19,1299,S2225
784,LAKSHMANAN,Independent,1087,0,1087,S2225
785,PARY T,Independent,1077,4,1081,S2225
786,ANANDARAJU R,Independent,1009,6,1015,S2225
787,JAYAKUMAR K,Samaniya Makkal Nala Katchi,1003,3,1006,S2225
788,TAMILSELVAN M,Independent,872,6,878,S2225
789,THANGAMANI K,Independent,868,5,873,S2225
790,P K AMMAN G SIVAKUMAR,Independent,740,15,755,S2225
791,EBINESAN M,Independent,731,17,748,S2225
792,MURUGANANTHAM T,Independent,730,3,733,S2225
793,SUDHAKAR S,Independent,550,5,555,S2225
794,SAMBATH D,Independent,530,2,532,S2225
795,MUTHUKUMAR,Independent,467,2,469,S2225
796,VEERAMALAI K,Independent,449,2,451,S2225
797,NOTA,None of the Above,10075,247,10322,S2225
798,TAPIR GAO,Bharatiya Janata Party,140715,4866,145581,S022
799,BOSIRAM SIRAM,Indian National Congress,109433,5727,115160,S022
800,TAMAT GAMOH,Independent,26691,912,27603,S022
801,SOTAI KRI,Independent,13227,986,14213,S022
802,OMAK NITIK,Independent,9074,295,9369,S022
803,BANDEY MILI,Arunachal Democratic Party,6419,203,6622,S022
804,NOTA,None of the Above,4654,241,4895,S022
805,KANGNA RANAUT,Bharatiya Janata Party,527463,9559,537022,S082
806,VIKRAMADITYA SINGH,Indian National Congress,453760,8507,462267,S082
807,DR. PRAKASH CHAND BHARDWAJ,Bahujan Samaj Party,4320,73,4393,S082
808,NARENDER KUMAR,Rashtriya Devbhumi Party,2422,25,2447,S082
809,RAKHEE GUPTA,Independent,1014,37,1051,S082
810,SUBHASH MOHAN SNEHI,Independent,963,11,974,S082
811,VINAY KUMAR,Akhil Bhartiya Parivar Party,674,16,690,S082
812,MAHESH  SAINI,Himachal Janta Party,641,13,654,S082
813,DINESH KUMAR BHATI,Independent,375,6,381,S082
814,ASHUTOSH MAHANT,Independent,260,26,286,S082
815,NOTA,None of the Above,5586,59,5645,S082
816,SATABDI ROY,All India Trinamool Congress,714972,2989,717961,S2542
817,DEBTANU BHATTACHARYA,Bharatiya Janata Party,517761,2550,520311,S2542
818,MILTON RASHID,Indian National Congress,225572,688,226260,S2542
819,AMIY GHOSH,Independent,11950,8,11958,S2542
820,LAKSHMI HEMBROM,Ambedkarite Party of India,7677,10,7687,S2542
821,AYESHA KHATUN,Socialist Unity Centre Of India (COMMUNIST),6761,18,6779,S2542
822,RAJNATH SARKAR,Bahujan Samaj Party,5866,16,5882,S2542
823,SAURAV MUDI,Independent,4249,7,4256,S2542
824,ABDUL IMRAN,Independent,3823,9,3832,S2542
825,BISWAJIT MISHRA,All India Arya Mahasabha,3806,17,3823,S2542
826,MD. JAKIR HOSSAIN,Bharatiya National Janata Dal,2547,10,2557,S2542
827,DOLA SARKAR,Indian National Socialistic Action Forces,2027,6,2033,S2542
828,NOTA,None of the Above,14037,56,14093,S2542
829,DEVUSINH CHAUHAN,Bharatiya Janata Party,738609,5826,744435,S0617
830,KALUSINH DABHI,Indian National Congress,381656,5021,386677,S0617
831,SODHA SANJAYKUMAR PARVATSINH,Independent,6123,16,6139,S0617
832,BHAILALBHAI KALUBHAI PANDAV,Bahujan Samaj Party,6055,97,6152,S0617
833,PARMAR HITESHKUMAR PARSOTTAMBHAI,Independent,2730,11,2741,S0617
834,UPENDRAKUMAR VALLAVBHAI PATEL,Independent,2703,12,2715,S0617
835,PATEL ANILKUMAR BHAILALBHAI,Rashtriya Mahaswaraj Bhumi Party,2493,30,2523,S0617
836,SAIYAD KADARI MOHAMMAD SABIR ANVAR HUSAIN,Bhartiya Jan Nayak Party,1812,26,1838,S0617
837,INDIRADEVI HIRALAL VORA,Garib Kalyan Party,1126,9,1135,S0617
838,KAMLESHBHAI POPATBHAI PATEL,Bhartiya Jan Parishad,933,16,949,S0617
839,IMRANBHAI VANKAWALA,Right to Recall Party,924,4,928,S0617
840,KANTIYA DASRATH HARJIVANBHAI,New India United Party,789,3,792,S0617
841,NOTA,None of the Above,18444,380,18824,S0617
842,AMRARAM,Communist Party of India  (Marxist),645559,13741,659300,S205
843,SUMEDHANAND SARASWATI,Bharatiya Janata Party,574740,11664,586404,S205
844,SURESH PAREEK,Independent,10014,7,10021,S205
845,AMARCHAND,Bahujan Samaj Party,8293,326,8619,S205
846,VISHNU KUMAR NATRAJ,Independent,5796,7,5803,S205
847,RAVINDRA SINGH SHEKHAWAT,Independent,5775,250,6025,S205
848,ASHOK SEHRA,Ambedkarite Party of India,5333,49,5382,S205
849,DHIRENDRA  VERMA,Ummeed Party of India,2885,59,2944,S205
850,MAHESH KUMAR,Independent,1962,94,2056,S205
851,BENI PRASAD KAUSHIK (LATA),Rashtriya Sawarn Dal,1720,11,1731,S205
852,RAMESH SHARMA,Bhartiya Party,1516,33,1549,S205
853,VIJENDER MAHARIA,Bharatiya Yuva Jan Ekta Party,1421,30,1451,S205
854,OM PRAKASH,Independent,1182,42,1224,S205
855,BIRBALSINGH,Independent,1034,47,1081,S205
856,NOTA,None of the Above,7081,185,7266,S205
857,GANAPATHY RAJKUMAR P,Dravida Munnetra Kazhagam,565428,2772,568200,S2220
858,ANNAMALAI K,Bharatiya Janata Party,447608,2524,450132,S2220
859,SINGAI G RAMACHANDRAN,All India Anna Dravida Munnetra Kazhagam,235603,887,236490,S2220
860,KALAMANI JAGANATHAN,Naam Tamilar Katchi,82387,270,82657,S2220
861,VELMURUGAN K,Bahujan Samaj Party,2364,11,2375,S2220
862,SANJAYKUMAR S,Independent,1787,2,1789,S2220
863,ANNADURAI R,Independent,1767,5,1772,S2220
864,SURESH M,Independent,1472,2,1474,S2220
865,GOPALAKRISHNAN S,Independent,1196,3,1199,S2220
866,RAGHUL GANDHI K,Hindustan Janta Party,1170,6,1176,S2220
867,KARTHICK T,Independent,1070,3,1073,S2220
868,RAJKUMAR M,Independent,1067,1,1068,S2220
869,RAJKUMAR,Independent,1010,3,1013,S2220
870,RAJKUMAR G,Independent,888,4,892,S2220
871,SHANMUGAM K,Independent,881,1,882,S2220
872,KRISHNAN V,Independent,722,4,726,S2220
873,RAMACHANDRAN M,Independent,663,0,663,S2220
874,RAJAMANICKAM N,Independent,626,3,629,S2220
875,RAJKUMAR G B,Independent,607,4,611,S2220
876,KUMAR A,Ganasangam Party of India,548,3,551,S2220
877,SANGEETHA R,Naadaalum Makkal Katchi,491,1,492,S2220
878,RICHARD VINCENT,Viro Ke Vir Indian Party,489,3,492,S2220
879,SURIYAKUMAR K,Independent,443,4,447,S2220
880,ARUNKANTH V,Independent,432,6,438,S2220
881,ANANDHAKUMAR S,Rashtriya Samaj Paksha,417,2,419,S2220
882,RAMACHANDRAN R,Independent,368,1,369,S2220
883,MUTHUSAMY P P,Independent,368,1,369,S2220
884,PALANISAMYRAAJ M,Independent,313,3,316,S2220
885,PUSHPANANTHAM V,Tamizhaga Murpokku Makkal Katchi,303,2,305,S2220
886,DINESH K,Independent,284,1,285,S2220
887,PREMKUMAR P,Independent,281,2,283,S2220
888,RAVICHANDRAN,Independent,271,1,272,S2220
889,DURAISAMY A,Independent,263,3,266,S2220
890,ZAHIR HUSSAIN,Independent,259,1,260,S2220
891,BOOBALAN,Independent,252,1,253,S2220
892,NOORMUHAMAD A,Independent,232,2,234,S2220
893,PASUPATHI S,Independent,170,3,173,S2220
894,NOTA,None of the Above,11677,111,11788,S2220
895,THIRUMAAVALAVAN THOL,Viduthalai Chiruthaigal Katchi,501851,3233,505084,S2227
896,CHANDRAHASAN M,All India Anna Dravida Munnetra Kazhagam,399502,2028,401530,S2227
897,KARTHIYAYINI P,Bharatiya Janata Party,166114,2379,168493,S2227
898,JANCIRANI R,Naam Tamilar Katchi,65116,473,65589,S2227
899,NEELAMEGAM K,Bahujan Samaj Party,3177,26,3203,S2227
900,TAMILVENDHAN P,Independent,3043,19,3062,S2227
901,PERUMAL S,Independent,2231,8,2239,S2227
902,VETTRIVEL G,Independent,2039,2,2041,S2227
903,ARCHUNAN M A T,Independent,1833,3,1836,S2227
904,DHAMODHARAN S,Naadaalum Makkal Katchi,1628,14,1642,S2227
905,RATHA G,Independent,1273,7,1280,S2227
906,RAJAMANICKAM C,Independent,1068,19,1087,S2227
907,CHINNADURAI A,Independent,628,10,638,S2227
908,ELAVARASAN C,Independent,584,2,586,S2227
909,NOTA,None of the Above,8631,130,8761,S2227
910,AJAY BHATT,Bharatiya Janata Party,766397,6274,772671,S284
911,PRAKASH JOSHI,Indian National Congress,434916,3207,438123,S284
912,AKHTAR ALI,Bahujan Samaj Party,23276,179,23455,S284
913,AKHALESH KUMAR,Akhil Bhartiya Parivar Party,4871,31,4902,S284
914,HITESH PATHAK,Independent,4287,28,4315,S284
915,RAMESH KUMAR MAX,Independent,3271,29,3300,S284
916,AMAR SINGH SAINI,Peoples Party of India (Democratic),2963,24,2987,S284
917,JEEVAN CHANDRA UPRETI,Bharat Ki Lok Jimmedar Party,2292,18,2310,S284
918,SHIB SINGH,Uttarakhand Kranti Dal,1809,46,1855,S284
919,SURENDRA SINGH,Bhartiya Shakti Chetna Party,1655,18,1673,S284
920,NOTA,None of the Above,10227,198,10425,S284
921,UTKARSH VERMA  'MADHUR',Samajwadi Party,555277,2088,557365,S2428
922,AJAY KUMAR,Bharatiya Janata Party,521954,1082,523036,S2428
923,ANSHAY KALRA,Bahujan Samaj Party,110122,338,110460,S2428
924,SANDHYA JAISWAL,Parivartan Samaj Party,3093,3,3096,S2428
925,SATENDRA KUMAR MAURYA,Independent,2980,2,2982,S2428
926,OM NATH SINGH,Rashtriya Shoshit Samaj Party,2298,2,2300,S2428
927,NARESH SINGH BHADAURIYA,Independent,2107,4,2111,S2428
928,MUKESH KUMAR  (BHARTI),Rashtriya Vikalp Party,1266,3,1269,S2428
929,KHANJAN,Netaji Subhash Chander Bose Rashtriya Azad Party,1018,1,1019,S2428
930,DARWARI URF  DARWARI LAL  CHAUHAN,Janta Kranti Party,935,1,936,S2428
931,KM. PANCHSHEELA ANAND,Uttar Pradesh Republican Party,845,9,854,S2428
932,NOTA,None of the Above,7915,16,7931,S2428
933,DR. RAJ KUMAR CHABBEWAL,Aam Aadmi Party,302402,1457,303859,S195
934,YAMINI GOMAR,Indian National Congress,257936,1812,259748,S195
935,ANITA SOM PARKASH,Bharatiya Janata Party,198576,1418,199994,S195
936,SOHAN SINGH THANDAL,Shiromani Akali Dal,91503,286,91789,S195
937,RANJIT KUMAR,Bahujan Samaj Party,47975,239,48214,S195
938,JASWANT SINGH,Shiromani Akali Dal (Amritsar)(Simranjit Singh Mann),20680,243,20923,S195
939,JEEVAN SINGH TAMIL,Bahujan Dravida Party,4607,14,4621,S195
940,ROHIT KUMAR TINKU,Independent,2417,2,2419,S195
941,RAJESH,Democratic Bharatiya Samaj Party,2330,6,2336,S195
942,SONU SINGH PHAGWARA,Independent,1871,13,1884,S195
943,DAVINDER SINGH,Independent,1584,33,1617,S195
944,HARDEEP SINGH,Nationalist Justice Party,1403,22,1425,S195
945,RAJPAL NADALI,Bahujan Mukti Party,1138,2,1140,S195
946,BHIMRAO YASHWANT AMBEDKAR,Global Republican Party,1034,7,1041,S195
947,SATPAL,Independent,978,15,993,S195
948,DAVINDER KUMAR SAROYA,Samaj Bhalai Morcha,923,7,930,S195
949,NOTA,None of the Above,5453,99,5552,S195
950,DR. MANSUKH MANDAVIYA,Bharatiya Janata Party,625962,7156,633118,S0611
951,LALIT VASOYA,Indian National Congress,245677,4081,249758,S0611
952,N. P. RATHOD,Bahujan Samaj Party,10560,362,10922,S0611
953,NATHABHAI BHURABHAI ODEDRA,Independent,7164,132,7296,S0611
954,LAKHANSI ODEDARA,Viro Ke Vir Indian Party,3130,33,3163,S0611
955,SOLANKI JATIN DHIRUBHAI,Independent,2469,17,2486,S0611
956,SODHA HUSHENBHAI ALIBHAI,Independent,2432,3,2435,S0611
957,RATHOD CHANDUBHAI MOHANBHAI,Independent,1705,24,1729,S0611
958,SHEKHAVA NILESHKUMAR RAMJIBHAI,Samajwadi Party,1587,22,1609,S0611
959,SIDHHAPARA HARSUKHLAL JIVANBHAI,Log Party,1059,13,1072,S0611
960,MAHEMUDBHAI SAIYAD,Independent,1023,6,1029,S0611
961,JETHAVA BIPINKUMAR BHIKHALAL,Independent,786,11,797,S0611
962,NOTA,None of the Above,13004,559,13563,S0611
963,"JANARDAN SINGH ""SIGRIWAL""",Bharatiya Janata Party,527974,1559,529533,S0419
964,AAKASH KUMAR SINGH,Indian National Congress,425887,995,426882,S0419
965,TRIBHUWAN RAM,Peoples Party of India (Democratic),14830,8,14838,S0419
966,MADHUSUDAN SINGH,Bahujan Samaj Party,13359,43,13402,S0419
967,AKHILESHWAR PRASAD SINGH,All India Majlis-E-Ittehadul Muslimeen,7750,17,7767,S0419
968,NOTA,None of the Above,21662,25,21687,S0419
969,KARAN BHUSHAN SINGH,Bharatiya Janata Party,570436,827,571263,S2457
970,BHAGAT RAM,Samajwadi Party,422012,408,422420,S2457
971,NARENDRA PANDEY,Bahujan Samaj Party,44217,62,44279,S2457
972,ARUNIMA PANDEY,Independent,9230,20,9250,S2457
973,NOTA,None of the Above,14872,15,14887,S2457
974,Sasikanth Senthil,Indian National Congress,794608,2348,796956,S221
975,"Balaganapathy, V. Pon",Bharatiya Janata Party,224042,759,224801,S221
976,"Nallathambi, K.",Desiya Murpokku Dravida Kazhagam,223550,354,223904,S221
977,"Jagadesh Chander, M.",Naam Tamilar Katchi,120620,218,120838,S221
978,"Tamizhmadhi, D.",Bahujan Samaj Party,13772,38,13810,S221
979,"Ashok Priyadarshan, S.",Desiya Makkal Sakthi Katchi,2937,9,2946,S221
980,Malathi,Naadaalum Makkal Katchi,2829,24,2853,S221
981,"Mani, E.",Independent,2745,7,2752,S221
982,"Devandhran, M.",Anna MGR Dravida Makkal Kalgam,2001,7,2008,S221
983,"Manimaran, V.",Independent,1921,1,1922,S221
984,"Balakrishnan, K.",Independent,1685,5,1690,S221
985,"Bharathidasan, S.S.",Independent,1619,12,1631,S221
986,"Shakthivel, A.J.",Independent,1605,8,1613,S221
987,"Sivasankaran, V.",Independent,1105,5,1110,S221
988,NOTA,None of the Above,18908,70,18978,S221
989,DR. VIRENDRA KUMAR,Bharatiya Janata Party,713781,1269,715050,S126
990,KHUMAN URF PANKAJ AHIRWAR,Indian National Congress,311134,604,311738,S126
991,AHIRWAR DALLURAM,Bahujan Samaj Party,32604,69,32673,S126
992,AHIRWAR PANKAJ,Rashtriya Samaj Paksha,10147,11,10158,S126
993,SARJU PRASAD,Independent,5993,4,5997,S126
994,N.R. PRAJAPATI,Adarsh Nyay Rakshak Party,5475,9,5484,S126
995,BABULAL KHANGAR,Independent,4452,7,4459,S126
996,NOTA,None of the Above,12816,15,12831,S126
997,YOGENDER CHANDOLIYA,Bharatiya Janata Party,863255,3228,866483,U055
998,UDIT RAJ,Indian National Congress,574451,1183,575634,U055
999,VIJAY BAUDDH,Bahujan Samaj Party,11955,42,11997,U055
1000,SURESH KUMAR,Peoples Party of India (Democratic),2869,1,2870,U055
1001,SANJAY KUMAR SIWAL,Rashtriya Janshakti Party (Secular),2866,0,2866,U055
1002,SUBHASH,Asankhya Samaj Party,2250,0,2250,U055
1003,RAJENDER SOOD,Aam Janshakti Party,1468,10,1478,U055
1004,PRAVEEN GAUTAM,Navarang Congress Party,1455,1,1456,U055
1005,K M KAJAL,Public Political Party,1334,8,1342,U055
1006,NARESH KUMAR,Independent,1270,5,1275,U055
1007,ADVOCATE SATISH CHANDRA,Ambedkarite Party of India,1236,1,1237,U055
1008,PARMENDRA MANJHI,Independent,1102,0,1102,U055
1009,ADVOCATE DR. MAHENDER   SINGH CHURIYANA,Bahujan Dravida Party,1015,1,1016,U055
1010,CHANDER PAL SONI,Independent,891,0,891,U055
1011,ADITI,Independent,790,0,790,U055
1012,ADV. KRUPAL,Prabuddha Republican Party,673,2,675,U055
1013,NAND RAM BAGRI,Voters Party  International,638,0,638,U055
1014,SHYAM BHARTEEY,Gareeb Aadmi Party,629,3,632,U055
1015,HARI KISHAN (MECHANIC),Independent,547,1,548,U055
1016,POOJA (BHAGTANI),Bharatiya Jan Jagriti Party,504,5,509,U055
1017,NARESH KUMAR,Rashtriya Samaj Paksha,499,1,500,U055
1018,PREETI,Saman Adhikar Party,495,8,503,U055
1019,SATYA PRAKASH UTTRAKHANDI,Independent,433,1,434,U055
1020,KHILKHILAKAR,Bahujan Shoshit Samaj Sangharsh Samta Party,372,1,373,U055
1021,PRADEEP KUMAR,Independent,371,0,371,U055
1022,PUSHPA NAGRA,Independent,353,0,353,U055
1023,NOTA,None of the Above,8917,67,8984,U055
1024,PATEL UMESHBHAI BABUBHAI,Independent,42469,54,42523,U031
1025,LALUBHAI BABUBHAI PATEL,Bharatiya Janata Party,36243,55,36298,U031
1026,KETAN DAHYABHAI PATEL,Indian National Congress,11237,21,11258,U031
1027,UMESH PATEL,Navsarjan Bharat Party,545,0,545,U031
1028,SAKIL LATIF KHAN,Independent,323,0,323,U031
1029,IDRISH G MULLA,Independent,247,0,247,U031
1030,PATEL UMESHBHAI BABU,Independent,238,0,238,U031
1031,NOTA,None of the Above,977,1,978,U031
1032,SRIBHARAT MATHUKUMILI,Telugu Desam,893884,13583,907467,S014
1033,JHANSI LAKSHMI. BOTCHA.,Yuvajana Sramika Rythu Congress Party,397821,5399,403220,S014
1034,P. SATYA REDDY,Indian National Congress,29430,837,30267,S014
1035,K.A. PAUL,Praja Shanthi Party,7529,167,7696,S014
1036,PEDAPENKI SIVA PRASADA RAO,Bahujan Samaj Party,6006,85,6091,S014
1037,BIKKAVOLU. CHALAMAJI,Navarang Congress Party,4883,1,4884,S014
1038,V.N. SATYA NARAYANA,Rashtriya Praja Congress  (Secular),2534,3,2537,S014
1039,ARUNA SRI MURALA,Independent,1991,2,1993,S014
1040,VASUPILLI SURESH,Independent,1931,2,1933,S014
1041,SONDI KRISHNA.,Independent,1811,7,1818,S014
1042,ANDUKURI VIJAYA BHASKAR,India Praja Bandhu Party,1098,11,1109,S014
1043,DR. GANAPATHI KONGARAPU.,Republican Party of India (A),944,6,950,S014
1044,BANNA. RAMESH,Dalita Bahujana Party,941,7,948,S014
1045,P. SATYA VANI,Pyramid Party of India,875,7,882,S014
1046,DURGA PRASAD. GUNTU,Bhartiya Rashtriya Dal,760,7,767,S014
1047,CHAPPIDI RAMU,Independent,756,1,757,S014
1048,M.G.M. KHAN,Independent,738,4,742,S014
1049,SHANKAR DEVARA YADAV,Independent,656,5,661,S014
1050,VENU MADHAV KARRI,Independent,646,1,647,S014
1051,DR. ACHUTHA BALAJI YADAV (MURAPALA),Bharatha Chaitanya Yuvajana Party,628,10,638,S014
1052,THOTA VENKATA SAI MUKUND,Praja Prasthanam Party,628,5,633,S014
1053,PIDIDHI APPARAO,Independent,576,4,580,S014
1054,G.A.N. ANAND,Independent,543,0,543,S014
1055,VADDI. HARI GANESH,Independent,518,2,520,S014
1056,JANARDHAN PONNADA.,Independent,499,1,500,S014
1057,GANAPATHI. JAGADEESWARA RAO (JAGADEESH),Jai Maha Bharath Party,494,6,500,S014
1058,JALADI VIJAYA KUMARI,Samajwadi Party,463,3,466,S014
1059,CHINTADA SURYAM,Naba Bharata Nirmana Seva Party,443,5,448,S014
1060,GANDIKOTA RAJESH,Navataram Party,392,1,393,S014
1061,KOLLI NAGA RAJU,Independent,322,7,329,S014
1062,METTA RAMA RAO,Independent,320,6,326,S014
1063,LAGUDU. GOVINDA RAO,Independent,293,1,294,S014
1064,MALLA SRAVANI,Independent,271,2,273,S014
1065,NOTA,None of the Above,5171,142,5313,S014
1066,KRIPANATH MALLAH,Bharatiya Janata Party,541220,3873,545093,S037
1067,HAFIZ RASHID AHMED CHOUDHURY,Indian National Congress,524390,2343,526733,S037
1068,SAHABUL ISLAM CHOUDHURY,All India United Democratic Front,29070,135,29205,S037
1069,JIBESH DEB,Independent,7105,4,7109,S037
1070,DEBOJYOTI NATH,Independent,5900,7,5907,S037
1071,AHAD UDDIN,Rashtriya Ulama Council,4186,6,4192,S037
1072,BINAY KRISHNA ROY,Independent,3621,7,3628,S037
1073,DILIP KUMAR,Independent,2623,7,2630,S037
1074,ROSID AHMED LASKAR,Independent,2600,1,2601,S037
1075,MUZAKKIR HASAN LASKAR,Independent,2287,4,2291,S037
1076,ABDUL BASIT TAPADAR,Independent,1912,11,1923,S037
1077,GOPAL CHANDRA PAUL,Independent,1650,7,1657,S037
1078,MD. NAZRUL ISLAM LASKAR,Independent,1382,0,1382,S037
1079,SAHEL AHMED,Independent,1110,1,1111,S037
1080,ABDUL GOFFAR TALUKDAR,Independent,1094,1,1095,S037
1081,SAFIKUR RAHMAN HAZARI,Independent,1031,0,1031,S037
1082,PRAJJWAL SUDIP DEB,Socialist Unity Centre Of India (COMMUNIST),994,7,1001,S037
1083,ABDUL KALAM MAZUMDER,Independent,975,0,975,S037
1084,ALIM UDDIN MAZUMDER,Independent,881,1,882,S037
1085,ABDUL HAMEED,Independent,841,1,842,S037
1086,DEBASHISH GHOSH,Bangali Nabanirman Sena,800,17,817,S037
1087,RASHID AHMED CHOUDHURY,Independent,719,2,721,S037
1088,ABDUS  SUBHAN TAPADAR,Independent,568,3,571,S037
1089,ROKIBUL HUSSAIN CHOUDHURY,Independent,539,6,545,S037
1090,NOTA,None of the Above,2851,89,2940,S037
1091,MUHAMMED HAMDULLAH SAYEED,Indian National Congress,25405,321,25726,U061
1092,MOHAMMED FAIZAL PP,Nationalist Congress Party – Sharadchandra Pawar,22837,242,23079,U061
1093,YOUSUF TP,Nationalist Congress Party,198,3,201,U061
1094,KOYA,Independent,58,3,61,U061
1095,NOTA,None of the Above,132,1,133,U061
1096,AASHTIKAR PATIL NAGESH BAPURAO,Shiv Sena (Uddhav Balasaheb Thackrey),490432,2103,492535,S1315
1097,BABURAO KADAM KOHALIKAR,Shiv Sena,382599,1334,383933,S1315
1098,DR. B. D. CHAVHAN,Vanchit Bahujan  Aaghadi,161324,490,161814,S1315
1099,AMBADAS SUKAJI GADE,Independent,14729,13,14742,S1315
1100,VIJAY RAMJI GABHANE,Communist Party of India  (Marxist),14617,27,14644,S1315
1101,ANAND RAJARAM DHULE,Independent,9807,10,9817,S1315
1102,GAJANAN DHONDBA DAL,Bahujan Samaj Party,7410,55,7465,S1315
1103,DATTA SHRIKRISHNA SURYAWANSHI,Independent,7233,6,7239,S1315
1104,SARJERAO NIVRUTTI KHANDARE,Independent,5010,4,5014,S1315
1105,RAMPRASAD NARAYAN BANGAR,Independent,4518,7,4525,S1315
1106,BABURAO ANANDRAO KADAM,Independent,4469,13,4482,S1315
1107,DEVSARKAR VARSHA SHIVAJIRAO,Bahujan Mukti Party,4081,18,4099,S1315
1108,A. KADIR MASTAN SAYYED (GOREGAONKAR),Independent,3707,6,3713,S1315
1109,ANIL DEVRAO MOHITE,Akhil Bhartiya Parivar Party,3353,21,3374,S1315
1110,SUNIL MOTIRAM GAJBHAR,Independent,3192,0,3192,S1315
1111,ADV ALTAF AHMED,Indian National League,2934,16,2950,S1315
1112,ASHOK PANDURANG RATHOD,Independent,2897,9,2906,S1315
1113,ADV RAVI SHINDE,Independent,2687,14,2701,S1315
1114,SATTAR PATHAN,Independent,2461,2,2463,S1315
1115,MAHESH KAILAS NAPTE,Independent,2298,1,2299,S1315
1116,ADV. SHIVAJIRAO JADHAV,Independent,2181,33,2214,S1315
1117,BHAWAR GOVINDRAO FULAJI,Independent,2138,8,2146,S1315
1118,TRISHALA MILIND KAMBLE,Bahujan Samaj Party  (Ambedkar),2128,22,2150,S1315
1119,PRAKASH MASARAM RANVIR,Republican Party of India (A),2097,5,2102,S1315
1120,ADV. RAMRAO ATMARAM JUMBADE,Independent,2095,9,2104,S1315
1121,DESHA SHYAM BANJARA,Samnak Janta Party,2052,11,2063,S1315
1122,VISHVANATH BHAURAO FALEGAONKAR,Independent,1856,3,1859,S1315
1123,HEMANT RADHAKISHAN KANAKE,Rashtriya Kisan Bahujan Party,1791,9,1800,S1315
1124,RAVI RAMDAS JADHAV (SAWANEKAR),Abhinav Bharat Janseva Paksh,1590,12,1602,S1315
1125,DEWJI GANGARAM ASOLE,Independent,1476,7,1483,S1315
1126,VIJAY DNYANBA RAUT,Independent,1115,11,1126,S1315
1127,SUNIL DASHARATH INGOLE,Bhim Sena,1024,4,1028,S1315
1128,VASANT KISAN PAIKRAO,Independent,590,3,593,S1315
1129,NOTA,None of the Above,3079,44,3123,S1315
1130,BIJULI KALITA  MEDHI,Bharatiya Janata Party,891901,2986,894887,S035
1131,MIRA BORTHAKUR GOSWAMI,Indian National Congress,642353,1444,643797,S035
1132,DIPAK KR BORO,Voters Party  International,8494,54,8548,S035
1133,COLONEL GOKUL CHANDRA SINGHA,Independent,7644,34,7678,S035
1134,AMITABH SARMA,Ekam Sanatan Bharat Dal,7508,19,7527,S035
1135,KAZI NEKIB  AHMED,Independent,6753,8,6761,S035
1136,SAMAD CHOUDHURY,Bharatiya Gana Parishad,5081,14,5095,S035
1137,SHEJON GOYARY,Bahujan Maha Party,4826,21,4847,S035
1138,NOTA,None of the Above,20139,110,20249,S035
1139,MIAN ALTAF AHMAD,Jammu & Kashmir National Conference,517489,4347,521836,U083
1140,MEHBOOBA MUFTI,Jammu & Kashmir Peoples Democratic Party,238210,1832,240042,U083
1141,ZAFAR IQBAL KHAN MANHAS,Jammu and Kashmir Apni Party,141316,879,142195,U083
1142,MOHAMAD SALEEM PARAY,Democratic Progressive Azad Party,25440,121,25561,U083
1143,ABDUL RAOUF MALIK,Independent,10566,16,10582,U083
1144,SUSHIL KUMAR SHARMA,Independent,9102,126,9228,U083
1145,ABDUL ROUF NAIK,Independent,9079,70,9149,U083
1146,SAJAD AHMAD DAR,Independent,7988,16,8004,U083
1147,IMRAN SHEIKH,Independent,7457,28,7485,U083
1148,IMTIYAZ AHMAD,National Loktantrik Party,6936,77,7013,U083
1149,ARSHEED AHMED LONE,Jammu & Kashmir National Panthers Party (Bhim),6163,226,6389,U083
1150,BALDEV KUMAR,Independent,6120,69,6189,U083
1151,ALI MOHAMMAD WANI,Independent,5238,17,5255,U083
1152,SHEIKH MUZAFAR AHMED,Jammu and Kashmir Nationalist People's Front,4774,40,4814,U083
1153,DILIP KUMAR PANDITA,Independent,3638,84,3722,U083
1154,RAVINDER SINGH,Independent,2828,134,2962,U083
1155,GULSHAN AKHTER,Independent,2778,29,2807,U083
1156,MOHAMMAD MAQBOOL TELI,Garib Democratic Party,2731,17,2748,U083
1157,SUDARSHAN SINGH,National Awami United Party,2166,216,2382,U083
1158,JAVAID AHMED,All India Forward Bloc,1534,28,1562,U083
1159,NOTA,None of the Above,5967,256,6223,U083
1160,S JAGATHRATCHAKAN,Dravida Munnetra Kazhagam,560578,2638,563216,S227
1161,L VIJAYAN,All India Anna Dravida Munnetra Kazhagam,255343,1314,256657,S227
1162,K BALU,Pattali Makkal Katchi,200614,1711,202325,S227
1163,S AFSHIA NASRIN,Naam Tamilar Katchi,97985,959,98944,S227
1164,D PANDIYAN,Bahujan Samaj Party,6135,77,6212,S227
1165,A PALANI,Independent,3855,11,3866,S227
1166,K MANIGANDAN,Independent,2045,4,2049,S227
1167,INDU W,Tamil Manila Murpokku Dravida Kazhagam,1872,66,1938,S227
1168,DR A V NARENDRAN,Independent,1711,11,1722,S227
1169,M VIJAYAN,Independent,1674,4,1678,S227
1170,M BALU,Independent,1557,4,1561,S227
1171,SHETTU S,Independent,1556,5,1561,S227
1172,V BABU,United Republican Party of India,1351,15,1366,S227
1173,M THULASIRAMAN,Independent,1046,7,1053,S227
1174,D JANAKIRAMAN,Independent,831,6,837,S227
1175,S SURESH KUMAR,Independent,828,7,835,S227
1176,R VINOTH,Veerath Thiyagi Viswanathadoss Thozhilalarkal Katchi,819,2,821,S227
1177,V VINAYAGAM,Independent,727,2,729,S227
1178,VIJAYAN K,All India Jananayaka Makkal Kazhagam,624,9,633,S227
1179,SHANAVAS J,Independent,580,3,583,S227
1180,V KRISHNANANDAN,Anna MGR Dravida Makkal Kalgam,568,14,582,S227
1181,A JAYACHANDRAN,Independent,534,4,538,S227
1182,N SUGUMAR,Independent,424,8,432,S227
1183,M VIJAY,Independent,416,11,427,S227
1184,G SUDHAKAR,Independent,367,13,380,S227
1185,K VENKATESAN,Independent,261,3,264,S227
1186,NOTA,None of the Above,12423,190,12613,S227
1187,BASTIPATI NAGARAJU PANCHALINGALA,Telugu Desam,650335,8579,658914,S0118
1188,B Y RAMAIAH,Yuvajana Sramika Rythu Congress Party,543801,3815,547616,S0118
1189,P.G.RAMPULLAIAH YADAV LUCKY-2,Indian National Congress,68972,1401,70373,S0118
1190,MANCHALA LAKSHMI NARAYANA,Bahujan Samaj Party,8533,56,8589,S0118
1191,BOYA SURESH,Independent,5891,9,5900,S0118
1192,T. BEECHUPALLI,Independent,5125,2,5127,S0118
1193,VIJAYA BHASKAR .REDDYPOGU,Independent,3504,4,3508,S0118
1194,PAGADALA KODANDA,Independent,3070,6,3076,S0118
1195,DEVARAPOGU MADDILETY,Independent,2576,6,2582,S0118
1196,PRAKASH REDDY RALAMPADU,Independent,2222,3,2225,S0118
1197,JAHANGIR AHMED,Social Democratic Party Of India,2058,16,2074,S0118
1198,DR. REDDYPOGU PRAVEEN KUMAR,Independent,1847,9,1856,S0118
1199,ABDUL SATTAR  A.S.R,Anna YSR Congress Party,1565,36,1601,S0118
1200,VALMIKI ARJUNA,Bharatha Chaitanya Yuvajana Party,1385,5,1390,S0118
1201,URUKUNDU VADDE,Independent,1284,11,1295,S0118
1202,MALLEPOGU NAGANNA,Socialist Unity Centre Of India (COMMUNIST),1162,2,1164,S0118
1203,SUNKARA SREEDHAR,Jai Bharat National Party,1149,14,1163,S0118
1204,TARIGOPULA RAJABABU,All Peoples Party,1032,1,1033,S0118
1205,AMRUTH KUMAR SALKAPURAM,Liberation Congress Party,777,6,783,S0118
1206,NOTA,None of the Above,10394,117,10511,S0118
1207,JOTHIMANI. S,Indian National Congress,531829,3077,534906,S2223
1208,THANGAVEL. L,All India Anna Dravida Munnetra Kazhagam,366209,1881,368090,S2223
1209,SENTHILNATHAN. V.V,Bharatiya Janata Party,101517,965,102482,S2223
1210,KARUPPAIYA. R,Naam Tamilar Katchi,86962,541,87503,S2223
1211,SANKARAN. S,Bahujan Samaj Party,2665,15,2680,S2223
1212,SAKTHIVEL. R,Independent,2391,22,2413,S2223
1213,ABILAZAN. N,Independent,1916,5,1921,S2223
1214,KARTHIKPERUMAL. R,Independent,1808,1,1809,S2223
1215,KATHIRAVAN. P,Independent,1445,3,1448,S2223
1216,KARUNAMOORTHY. S,Independent,1278,0,1278,S2223
1217,MOHAMED NAZEEM. S,Independent,938,0,938,S2223
1218,PALANISAMY. N.A,Independent,934,0,934,S2223
1219,SHANMUGAM. N,Samaniya Makkal Nala Katchi,924,5,929,S2223
1220,KALAIRAJ. K,Independent,809,2,811,S2223
1221,JOTHIMANI. A.K,Independent,805,3,808,S2223
1222,KANNAN. T,Independent,782,6,788,S2223
1223,JOTHIMANI. S,Independent,774,6,780,S2223
1224,SATHASIVAM. R,Independent,728,1,729,S2223
1225,MANIKANDAN. K,Independent,685,0,685,S2223
1226,KOSAMALAR. P,Independent,641,3,644,S2223
1227,MURUGESAN. K,Ganasangam Party of India,628,2,630,S2223
1228,MAHESWARAN. A,Independent,589,1,590,S2223
1229,REGIS THIYAGARAJAN. V.G.A,Independent,570,2,572,S2223
1230,VINCENT. F,Anti Corruption Dynamic Party,510,5,515,S2223
1231,NATRAYAN. R,Independent,503,0,503,S2223
1232,BANUMATHY. S,Independent,494,2,496,S2223
1233,UMADEVI. S,Independent,452,1,453,S2223
1234,VARADAN. M,Independent,428,1,429,S2223
1235,MURALI. M,Independent,417,0,417,S2223
1236,SAKTHIVEL. N,Independent,414,1,415,S2223
1237,BABU. G,Independent,387,0,387,S2223
1238,JAFAR ALI. A,Independent,368,3,371,S2223
1239,PRABHU. G,Independent,354,0,354,S2223
1240,PALANIVEL. P,Independent,350,0,350,S2223
1241,ANBAZHAGAN. T,Independent,338,1,339,S2223
1242,MURUGESAN. P,Independent,327,0,327,S2223
1243,SOWMIYA. R,Independent,307,3,310,S2223
1244,SATHISHKUMAR. S,Independent,304,2,306,S2223
1245,DHURAIYARASAN. P,Independent,273,2,275,S2223
1246,VINOTH KUMAR. N,Independent,273,3,276,S2223
1247,SATHIS KUMAR. C,Independent,258,9,267,S2223
1248,THIRUGNANAM. M,Independent,253,5,258,S2223
1249,SATHISH. P,Independent,241,3,244,S2223
1250,MAHAMUNI. A,Independent,213,0,213,S2223
1251,RAJAPANDIAN. K,Independent,207,2,209,S2223
1252,JOTHIVEL. A,Independent,206,0,206,S2223
1253,BASKARAN. N,Independent,205,0,205,S2223
1254,PUSHPARAJ. N,Independent,199,0,199,S2223
1255,NARENDRAKUMAR. G,Independent,197,0,197,S2223
1256,PRASANTH. S,Independent,194,0,194,S2223
1257,SUBASH MALAYALAM. T,Independent,186,0,186,S2223
1258,NAGESVARAN. P,Independent,185,0,185,S2223
1259,DANIYA. P,Independent,165,0,165,S2223
1260,SIVAKUMAR. V,Independent,150,1,151,S2223
1261,NOTA,None of the Above,8174,101,8275,S2223
1262,ANURAG SHARMA,Bharatiya Janata Party,689438,878,690316,S2446
1263,"PRADEEP JAIN ""ADITYA""",Indian National Congress,587000,702,587702,S2446
1264,RAVI PRAKASH,Bahujan Samaj Party,63106,86,63192,S2446
1265,LAKHAN LAL,Independent,6832,0,6832,S2446
1266,RAMESH,Independent,6330,8,6338,S2446
1267,GANESH RAM,Independent,2574,1,2575,S2446
1268,CHANDAN SINGH,Apna Dal (Kamerawadi),2487,4,2491,S2446
1269,DHARMENDRA PRATAP,Independent,2299,4,2303,S2446
1270,INDRA SINGH,Independent,2076,2,2078,S2446
1271,ER. DEEPAK KUMAR VERMA,Al-Hind Party,1375,2,1377,S2446
1272,NOTA,None of the Above,15290,12,15302,S2446
1273,HARISH CHANDRA MEENA,Indian National Congress,617137,6626,623763,S2012
1274,SUKHBIR SINGH JAUNAPURIA,Bharatiya Janata Party,553309,5505,558814,S2012
1275,PRAHALAD MALI,Bahujan Samaj Party,13089,55,13144,S2012
1276,GANESH MEENA,Indian Peoples Green Party,7425,8,7433,S2012
1277,MAKHAN LAL MEENA,Independent,3314,10,3324,S2012
1278,JASRAM MEENA,Independent,3044,1,3045,S2012
1279,VIJENDRA,Aazad Samaj Party (Kanshi Ram),2669,28,2697,S2012
1280,GIRRAJ PRASAD MEENA,Independent,2512,9,2521,S2012
1281,JAGDISH PRASAD MEENA,Bharat Adivasi Party,1366,7,1373,S2012
1282,DULI CHAND SAINI,Rajasthan Raj Party,1253,11,1264,S2012
1283,JAGDISH PRASAD SHARMA,Bheem Tribal Congress,1023,6,1029,S2012
1284,NOTA,None of the Above,8105,72,8177,S2012
1285,AWADHESH PRASAD,Samajwadi Party,553549,740,554289,S2454
1286,LALLU SINGH,Bharatiya Janata Party,499002,720,499722,S2454
1287,SACHIDANAND PANDEY,Bahujan Samaj Party,46347,60,46407,S2454
1288,ARVIND SEN,Communist Party of India,15353,14,15367,S2454
1289,SUNIL KUMAR BHATT,Independent,3826,1,3827,S2454
1290,KANCHAN YADAV,Moulik Adhikar Party,2662,4,2666,S2454
1291,AMBRISH DEV GUPTA,Bharat Mahaparivar Party,2216,2,2218,S2454
1292,FAREED SALMANI,Independent,1779,1,1780,S2454
1293,LAL MANI URF L.M. TRIPATHI (BHAI SAHAB),Independent,1717,0,1717,S2454
1294,ANIL KUMAR RAVAT,Rashtriya Janshakti Samaj Party,1636,2,1638,S2454
1295,JAGAT SINGH,Independent,1252,2,1254,S2454
1296,BRAJENDRA DUTT TRIPATHI URF B. D. TRIPATHI,Adarshwaadi Congress Party,1163,10,1173,S2454
1297,ARUN KUMAR,Independent,1063,4,1067,S2454
1298,NOTA,None of the Above,7529,7,7536,S2454
1299,VIJAYLAKSHMI DEVI,Janata Dal  (United),385625,883,386508,S0418
1300,HENA SHAHAB,Independent,293084,567,293651,S0418
1301,AWADH BIHARI CHOUDHARY,Rashtriya Janata Dal,198063,760,198823,S0418
1302,SATYENDRA KUSHWAHA,Independent,21558,7,21565,S0418
1303,JEEWAN KUMAR,Independent,18489,101,18590,S0418
1304,DILIP KU SINGH,Bahujan Samaj Party,12032,80,12112,S0418
1305,SANJAY KUMAR SAH,Bhartiya Lok Nayak Party,8851,28,8879,S0418
1306,DR. RAVINDRA NATH SHUKLA,Independent,8681,12,8693,S0418
1307,DEVKANT MISHRA,Independent,6162,19,6181,S0418
1308,PRAMOD KUMAR,Independent,5666,2,5668,S0418
1309,PRAKASH MANI TIWARI,Independent,4503,6,4509,S0418
1310,MAHENDRA SINGH ALIAS MAHENDRA RAI,Independent,3920,2,3922,S0418
1311,DILIP KUMAR SINGH,Independent,1947,6,1953,S0418
1312,NOTA,None of the Above,26925,39,26964,S0418
1313,MALAIYARASAN D,Dravida Munnetra Kazhagam,558346,3243,561589,S2214
1314,KUMARAGURU R,All India Anna Dravida Munnetra Kazhagam,505577,2228,507805,S2214
1315,JAGADESAN A,Naam Tamilar Katchi,73098,554,73652,S2214
1316,DEVADASS RAMASAMY,Pattali Makkal Katchi,70633,657,71290,S2214
1317,PRABU C,Independent,4268,7,4275,S2214
1318,BALAKRISHNAN P,Independent,3468,1,3469,S2214
1319,JEEVANRAJ N,Bahujan Samaj Party,3075,21,3096,S2214
1320,MAYILAMPARAI MARI A,Independent,2891,1,2892,S2214
1321,NATTANMAI GUNASEKARANA A.S,Anna Makkal Katchi,2497,8,2505,S2214
1322,KUMARAGURU N,Independent,2226,1,2227,S2214
1323,MURUGESAN M,Independent,2223,2,2225,S2214
1324,SUBRAMANIAN R K,Independent,868,4,872,S2214
1325,ARUL INIYAN A,Independent,772,12,784,S2214
1326,VENKATRAMAN J,Naadaalum Makkal Katchi,687,4,691,S2214
1327,KAMALAKANNAN M,Independent,629,1,630,S2214
1328,GOVINDARAJ S R,Independent,533,25,558,S2214
1329,PALANIYAMMAL S,Desiya Makkal Sakthi Katchi,533,15,548,S2214
1330,SIGAMANI A,Independent,515,27,542,S2214
1331,RAJASEKAR K,Independent,501,10,511,S2214
1332,JAYABAL PM,Independent,473,3,476,S2214
1333,RAJAMANICKAM C,Independent,398,1,399,S2214
1334,NOTA,None of the Above,8351,181,8532,S2214
1335,THANGA TAMILSELVAN,Dravida Munnetra Kazhagam,569110,2383,571493,S2233
1336,TTV DHINAKARAN,Amma Makkal Munnettra Kazagam,289909,2759,292668,S2233
1337,NARAYANASAMY V T,All India Anna Dravida Munnetra Kazhagam,154871,716,155587,S2233
1338,MADHAN,Naam Tamilar Katchi,75495,1339,76834,S2233
1339,PRAKASH P,Independent,6293,5,6298,S2233
1340,PANDIKUMAR S,Independent,3907,60,3967,S2233
1341,AJEETHKUMAR S,Independent,2977,29,3006,S2233
1342,PARAMASIVAN S,Independent,2852,14,2866,S2233
1343,PARTHIBAN G,Independent,2275,2,2277,S2233
1344,JEEVA M,Bahujan Samaj Party,2123,99,2222,S2233
1345,CHARCHIL DURAI P,Humanity for Peace Party,1905,30,1935,S2233
1346,PREMA S,Independent,1225,7,1232,S2233
1347,MANIKANDAN R,Independent,1195,6,1201,S2233
1348,REVATHI K,Independent,1115,13,1128,S2233
1349,MUDIYARASU,All India Youth Development Party,1078,16,1094,S2233
1350,THIAGARAJAN O V,Independent,924,8,932,S2233
1351,VASANTHA SARAVANAN,Independent,803,2,805,S2233
1352,VIJAYAN K,Independent,665,2,667,S2233
1353,SETHUPATHI G,Independent,613,4,617,S2233
1354,JOHNGILBERTRAJ,Independent,598,5,603,S2233
1355,AATHIMUTHUKUMAR M,Independent,587,5,592,S2233
1356,MUTHUKUMAR,Independent,539,4,543,S2233
1357,HARIKRISHNAKUMAR R,Independent,481,5,486,S2233
1358,SATHEESH KUMAR A,Independent,447,6,453,S2233
1359,KUMAR,Independent,376,1,377,S2233
1360,NOTA,None of the Above,11206,130,11336,S2233
1361,ATUL GARG,Bharatiya Janata Party,853036,1134,854170,S2412
1362,DOLLY SHARMA,Indian National Congress,516699,506,517205,S2412
1363,NAND KISHOR PUNDIR,Bahujan Samaj Party,79387,138,79525,S2412
1364,RAVI KUMAR PANCHAL,Independent,1965,1,1966,S2412
1365,ANAND KUMAR,Rashtra Nirman Party,1174,4,1178,S2412
1366,NATTHUSINGH CHAUDHARY,Independent,1159,3,1162,S2412
1367,AURANGJEB,Independent,1120,0,1120,S2412
1368,NAMAHA,Samaj Vikas Kranti Party,1079,1,1080,S2412
1369,AVDESH KUMAR,Independent,1037,6,1043,S2412
1370,POOJA SAXENA,Right to Recall Party,874,4,878,S2412
1371,KAVITA,Independent,772,3,775,S2412
1372,ANSUL GUPTA,Rashtriya Jan Karmath Party,763,1,764,S2412
1373,DHIRENDRA SINGH BHADAURIYA,Subhashwadi Bhartiya Samajwadi Party (Subhas Party),696,4,700,S2412
1374,ABHISHEK PUNDIR,Independent,652,1,653,S2412
1375,NOTA,None of the Above,8195,16,8211,S2412
1376,RAMBHUAL NISHAD,Samajwadi Party,442886,1444,444330,S2438
1377,MANEKA SANJAY GANDHI,Bharatiya Janata Party,399859,1297,401156,S2438
1378,UDRAJ VERMA,Bahujan Samaj Party,162603,422,163025,S2438
1379,ABDUL MABOOD,Apna Desh Party,4295,2,4297,S2438
1380,MOHAMMAD ASIF,Independent,3382,5,3387,S2438
1381,UDAYRAJ VERMA,Independent,2900,9,2909,S2438
1382,GIRISH LAL,Azad Party,2305,6,2311,S2438
1383,DR SHIV SHANKAR INDIAN,Most Backward Classes Of India,2085,5,2090,S2438
1384,JAY PRAKASH,Sardar Patel Siddhant Party,1364,5,1369,S2438
1385,NOTA,None of the Above,8500,13,8513,S2438
1386,RAO INDERJIT SINGH,Bharatiya Janata Party,805161,3175,808336,S079
1387,RAJ BABBAR,Indian National Congress,731696,1561,733257,S079
1388,RAHUL YADAV FAZILPURIA,Jannayak Janta Party,13214,64,13278,S079
1389,VIJAY KHATANA,Bahujan Samaj Party,8900,46,8946,S079
1390,SORAB KHAN,Indian National Lok Dal,4897,20,4917,S079
1391,AJAY KUMAR,Independent,3527,1,3528,S079
1392,ASHOK JANGRA,Independent,3002,3,3005,S079
1393,AZAD SINGH,Independent,2744,1,2745,S079
1394,AKSHAT GAIT,Independent,2549,1,2550,S079
1395,LAL CHAND YADAV,Bharatheeya Jawan Kisan Party,2214,8,2222,S079
1396,SAMAY SINGH,Independent,1885,2,1887,S079
1397,DHARMENDER THAKRAN,Swayam Shashan Party,1402,6,1408,S079
1398,VIJAY YADAV,Jan Sewak Kranti Party,1120,0,1120,S079
1399,ISHWAR SINGH SUTHANI,Peoples Party of India (Democratic),1110,4,1114,S079
1400,COMRADE SARWAN KUMAR GUPTA,Socialist Unity Centre Of India (COMMUNIST),1066,8,1074,S079
1401,VANDNA GULIYA,Right to Recall Party,980,20,1000,S079
1402,SAMPOORN ANAND,Rashtriya Lokswaraj Party,911,4,915,S079
1403,KUSHESHWAR  BHAGAT,Independent,794,0,794,S079
1404,SINGH RAM,Independent,789,2,791,S079
1405,ANWAR,Social Democratic Party Of India,572,6,578,S079
1406,FAUJI JAI KAWAR TYAGI (DIXIT),Independent,469,5,474,S079
1407,AKASH VYAS,Bhartiya Shakti Chetna Party,436,3,439,S079
1408,VISHNU,Independent,436,1,437,S079
1409,NOTA,None of the Above,6377,40,6417,S079
1410,SHRIRANG APPA CHANDU BARNE,Shiv Sena,692101,731,692832,S1333
1411,SANJOG BHIKU WAGHERE PATIL,Shiv Sena (Uddhav Balasaheb Thackrey),595542,675,596217,S1333
1412,MADHAVITAI  NARESH JOSHI,Vanchit Bahujan  Aaghadi,27745,23,27768,S1333
1413,RAJARAM NARAYAN PATIL,Bahujan Samaj Party,13982,21,14003,S1333
1414,ADV JYOTISHWAR VISHNU BHOSALE,Baliraja Party,10874,5,10879,S1333
1415,UMAKANT RAMESHWAR MISHRA,Independent,5029,1,5030,S1333
1416,SANJOG  PATIL,Independent,4828,2,4830,S1333
1417,KAMBLE MARUTI APARAI,Independent,4827,2,4829,S1333
1418,AJAY HANUMANT LONDHE,Independent,4766,1,4767,S1333
1419,SANTOSH UBALE,Bhim Sena,3824,1,3825,S1333
1420,ADHALGE LAXMAN SADASHIV,Independent,3166,1,3167,S1333
1421,SUHAS MANOHAR RANE,Independent,2923,0,2923,S1333
1422,IQBAL IBRAHIM NAWDEKAR,Independent,2899,1,2900,S1333
1423,DADARAO KISAN KAMBLE,Independent,2636,6,2642,S1333
1424,RAHUL NIVRUTTI MADANE,Independent,2279,3,2282,S1333
1425,TUSHAR DIGAMBAR LONDHE,Bahujan Bharat Party,2199,4,2203,S1333
1426,RAHIM MAINUDDIN SAYYAD,Aazad Samaj Party (Kanshi Ram),2148,1,2149,S1333
1427,INDRAJEET D GOND,Independent,2135,0,2135,S1333
1428,SHIVAJI KISAN JADHAV,All India Forward Bloc,1672,4,1676,S1333
1429,YASHWANT VITTHAL PAWAR,Kranti Kari Jai Hind Sena,1634,4,1638,S1333
1430,PRAFUL PANDIT BHOSALE,Independent,1602,1,1603,S1333
1431,RAJENDRA MARUTI KATE,Independent,1417,2,1419,S1333
1432,MAHESH THAKUR,Dharmarajya Paksha,1369,3,1372,S1333
1433,PRASHANT RAMKRISHNA BHAGAT,Bharatheeya Jawan Kisan Party,1283,8,1291,S1333
1434,PANKAJ PRABHAKAR OZARKAR,Akhil Bhartiya Parivar Party,1259,2,1261,S1333
1435,MANOJ BHASKAR GARBADE,Independent,1233,0,1233,S1333
1436,HAJRAT IMAMSAB PATEL,Independent,1093,0,1093,S1333
1437,GOVIND GANGARAM HERODE,Independent,966,0,966,S1333
1438,MADHUKAR DAMODAR THORAT,Independent,905,0,905,S1333
1439,RAFIQUE RASHID QURESHI,Desh Janhit Party,829,0,829,S1333
1440,CHIMAJI DHONDIBA SHINDE,Independent,757,0,757,S1333
1441,ADV RAJU PATIL,Independent,669,1,670,S1333
1442,MUKESH MANOHAR AGARWAL,Independent,546,1,547,S1333
1443,NOTA,None of the Above,16729,31,16760,S1333
1444,RAO RAJENDRA SINGH,Bharatiya Janata Party,608189,9688,617877,S206
1445,ANIL CHOPRA,Indian National Congress,602293,13969,616262,S206
1446,HANUMAN SAHAY,Bahujan Samaj Party,3773,77,3850,S206
1447,RAMSINGH KASANA,Independent,3701,6,3707,S206
1448,DR DASHRATH HINUNIA,Ambedkarite Party of India,2669,12,2681,S206
1449,KAHANVI BOHRA,Independent,1658,53,1711,S206
1450,DR RAM ROOP MEENA ADVOCATE,Independent,1589,15,1604,S206
1451,NEHA SINGH GURJAR,Independent,1378,29,1407,S206
1452,PRAKASH KUMAR SHARMA,Independent,1033,7,1040,S206
1453,AJAY BHAT,Republican Party of India (A),931,17,948,S206
1454,DEVHANS,Independent,924,17,941,S206
1455,DR OM SINGH MEENA SEHARA,Independent,676,58,734,S206
1456,ADITYA PRAKASH SHARMA,Right to Recall Party,650,16,666,S206
1457,YOGI JEETENDRA NATH ADVOCATE,Rashtriya Sawarn Dal,556,6,562,S206
1458,ADVOCATE HARI KISHAN TIWARI,Bheem Tribal Congress,541,4,545,S206
1459,NOTA,None of the Above,7405,114,7519,S206
1460,MALVINDER SINGH KANG,Aam Aadmi Party,312241,976,313217,S196
1461,VIJAY INDER SINGLA,Indian National Congress,301414,957,302371,S196
1462,DR SUBHASH SHARMA,Bharatiya Janata Party,185836,742,186578,S196
1463,PREM SINGH CHANDUMAJRA,Shiromani Akali Dal,117651,285,117936,S196
1464,JASVIR SINGH GARHI,Bahujan Samaj Party,89953,204,90157,S196
1465,KUSHAL PAL SINGH MANN,Shiromani Akali Dal (Amritsar)(Simranjit Singh Mann),24725,106,24831,S196
1466,GAJJAN SINGH,Independent,6164,7,6171,S196
1467,SIMPLE KUMAR,Independent,2962,0,2962,S196
1468,SATPAL,Independent,2294,3,2297,S196
1469,GURMIT SINGH,Independent,2179,3,2182,S196
1470,DHARMINDER SINGH HARMAN,Akhil Bhartiya Parivar Party,2037,6,2043,S196
1471,SUNIL KUMAR,Bhartiya Jan Samman Party,1968,9,1977,S196
1472,ER DALJEET SINGH SAINI,Bharatheeya Jawan Kisan Party,1710,5,1715,S196
1473,KULWINDER SINGH,Democratic Bharatiya Samaj Party,1651,1,1652,S196
1474,SUNAINA,Bhartiya Rashtriya Dal,1621,19,1640,S196
1475,ADV KULWINDER SINGH,Independent,1596,4,1600,S196
1476,MEGH RAJ,Independent,1429,1,1430,S196
1477,HARWINDER KARWAL,Independent,1309,2,1311,S196
1478,DAVINDER SINGH,Independent,1164,11,1175,S196
1479,DARSHAN SINGH,Punjab National Party,1164,8,1172,S196
1480,HANISH SHARMA,Ekam Sanatan Bharat Dal,1072,4,1076,S196
1481,DEEPAK SHARMA,Independent,1012,0,1012,S196
1482,PARMINDER SINGH,Independent,930,0,930,S196
1483,YOG RAJ SAHOTA,Revolutionary Socialist Party,925,0,925,S196
1484,RAMJAAN KHAN,Independent,672,0,672,S196
1485,ROHTASH,Independent,617,2,619,S196
1486,MANDAR SINGH,Independent,555,0,555,S196
1487,KIRAN JAIN,Hindustan Shakti Sena,507,8,515,S196
1488,NOTA,None of the Above,6351,51,6402,S196
1489,DR.K.SUDHAKAR,Bharatiya Janata Party,819588,3031,822619,S1027
1490,M.S. RAKSHA RAMAIAH,Indian National Congress,657489,1670,659159,S1027
1491,MUNIVENKATAPPA M.P,Communist Party of India  (Marxist),4546,11,4557,S1027
1492,MAHADEV. P,Bahujan Samaj Party,4428,12,4440,S1027
1493,RAJANNA,Independent,3759,5,3764,S1027
1494,RAJA REDDY,Independent,3377,4,3381,S1027
1495,KALAVATHI. N,Socialist Unity Centre Of India (COMMUNIST),2736,8,2744,S1027
1496,VALASAPALLI UTAPPA,Independent,2152,10,2162,S1027
1497,VENKATESHMURTHY.V,Uttama Prajaakeeya Party,2015,5,2020,S1027
1498,D. SUDHAKARA,Independent,1678,11,1689,S1027
1499,SUDHAKAR. N,Independent,1581,10,1591,S1027
1500,G N RAVI,Independent,1462,3,1465,S1027
1501,BHASKAR ANKALAMADUGU SHIVAREDDY,Independent,1363,4,1367,S1027
1502,CHANDRASHEKAR. H.C,Independent,1270,12,1282,S1027
1503,MOHITH NARASIMHAMURTHY,Independent,1222,7,1229,S1027
1504,V.N. NARASIMHAMURTHY VADIGERE,Independent,1212,6,1218,S1027
1505,G.N. VENKATESH B.A.L.L.B,Independent,1199,8,1207,S1027
1506,DEVARAJ CORONA WARRIOR,Independent,1168,9,1177,S1027
1507,G SUBRAMANI SHETTY,Karnataka Rashtra Samithi,869,3,872,S1027
1508,DR. M.R. RANGANATHA,Independent,850,7,857,S1027
1509,NAGESH. S,Digvijaya Bharatha Party,843,7,850,S1027
1510,T.R. NARAYANA RAO,Indian Labour Party (Ambedkar Phule),757,5,762,S1027
1511,"C.V.  LOKESH GOWDA, B.E",Independent,691,10,701,S1027
1512,D. CHINNAPPA,Independent,616,3,619,S1027
1513,SANDESH.G,Independent,588,6,594,S1027
1514,NASURULLA,Independent,579,4,583,S1027
1515,K. VENKATESH,Independent,469,5,474,S1027
1516,T VENKATA SIVUDU,Independent,434,6,440,S1027
1517,G N. KODANDAREDDY,Independent,399,2,401,S1027
1518,NOTA,None of the Above,6545,51,6596,S1027
1519,KUNDURU RAGHUVEER,Indian National Congress,772264,12073,784337,S2913
1520,SAIDI REDDY SHANAMPUDI,Bharatiya Janata Party,219606,4826,224432,S2913
1521,KANCHARLA KRISHNA REDDY,Bharat Rashtra Samithi,216681,1736,218417,S2913
1522,JANAIAH NANDIPATI,Telangana Sakalajanula Party,10832,27,10859,S2913
1523,NAGARAJU BANDARU,Independent,7122,6,7128,S2913
1524,ANJAIAH VIRIGINENI,Bahujan Samaj Party,7075,102,7177,S2913
1525,MARAM VENKAT REDDY,Independent,5962,5,5967,S2913
1526,PANUGOTU LALASINGH,Independent,5277,9,5286,S2913
1527,THALARI RAMBABU,Dharma Samaj Party,5028,94,5122,S2913
1528,RAMESH SUNKARA,Independent,3566,3,3569,S2913
1529,POLISHETTY VENKATESHWARLU,Independent,3202,10,3212,S2913
1530,KUKKALA VENKANNA,Independent,2561,5,2566,S2913
1531,CHOLLETI PRABHAKAR,Independent,2482,22,2504,S2913
1532,GOLI SAIDULU,Independent,1770,9,1779,S2913
1533,MARRI NEHEMIAH,Independent,1653,9,1662,S2913
1534,RAVI PALAKURI,Independent,1545,2,1547,S2913
1535,VASKULA MATTAIAH,Marxist Communist Party of India (United),1033,7,1040,S2913
1536,KUNDARAPU SRIKANTH,Independent,940,7,947,S2913
1537,RACHA SUBHADRA REDDY,Socialist Party (India),835,11,846,S2913
1538,LINGAM KRISHNA,Independent,666,0,666,S2913
1539,KINNERA YADAIAH,Independent,654,7,661,S2913
1540,SHIRISHALA SRINAIAH,Independent,513,1,514,S2913
1541,NOTA,None of the Above,5869,217,6086,S2913
1542,ZIA UR REHMAN,Samajwadi Party,570745,416,571161,S248
1543,PARMESHWAR LAL SAINI,Bharatiya Janata Party,448983,684,449667,S248
1544,CHAUDHARY SAULAT ALI,Bahujan Samaj Party,152317,143,152460,S248
1545,WASEEM SO MOH SHAMIM,Independent,3863,1,3864,S248
1546,MOHD WASEEM SO MOHD FAREED,Independent,2077,0,2077,S248
1547,JAYGAMUL ISLAM,Janta Shashan Party,1940,2,1942,S248
1548,ANUJ VARSHNEY,Independent,1674,3,1677,S248
1549,MAHANDRA SINGH,Independent,1291,3,1294,S248
1550,SANTOSH,Kisan Kranti Dal,1201,3,1204,S248
1551,DR RASHID,Peace Party,1059,1,1060,S248
1552,TAUFIK AHAMAD,Independent,722,1,723,S248
1553,PAVAN KUMAR,Log Party,636,1,637,S248
1554,NOTA,None of the Above,7213,4,7217,S248
1555,BALRAM NAIK PORIKA,Indian National Congress,608505,4269,612774,S2916
1556,KAVITHA MALOTH,Bharat Rashtra Samithi,262416,1193,263609,S2916
1557,PROFESSOR. AZMEERA SEETARAM NAIK,Bharatiya Janata Party,108775,1669,110444,S2916
1558,ARUN KUMAR MYPATHI,All India Forward Bloc,38252,884,39136,S2916
1559,RAGHU VARMA JATOTHU,Alliance of Democratic Reforms Party,11879,14,11893,S2916
1560,DURGA PALVANCHA,Independent,10112,7,10119,S2916
1561,KONETI SUJATHA,Bahujan Samaj Party,8058,35,8093,S2916
1562,ANIL KUMAR BODA,Independent,6419,12,6431,S2916
1563,CHANDA LINGAIAH,Independent,5075,25,5100,S2916
1564,MOKALLA MURALIKRISHNA,Independent,4056,6,4062,S2916
1565,SOYAM KANNA RAJU,Gondvana Gantantra Party,3727,28,3755,S2916
1566,BANOTH PREM NAYAK [BPN],Independent,3707,5,3712,S2916
1567,PAYAM.SINGARAJU,Independent,3192,4,3196,S2916
1568,PADIGA YARRAIAH,Independent,2873,14,2887,S2916
1569,DV NAIK,Independent,2780,1,2781,S2916
1570,GUGULOTH SHEKAR NAIK,Independent,2533,9,2542,S2916
1571,RAVVA. BHADRAMMA,Dharma Samaj Party,2234,10,2244,S2916
1572,SODE VENKATESWARLU,Gondwana Dandkaranya Party,2154,18,2172,S2916
1573,BANOTH LINGYA NAIK,Independent,1712,3,1715,S2916
1574,BODA PRASHANTH,Independent,1588,2,1590,S2916
1575,BURKA KRISHNAVENI,Socialist Party (India),1438,10,1448,S2916
1576,BANOTHU LINGANNA,Blue India Party,1367,0,1367,S2916
1577,VANKUDOTHU RAVI KUMAR (RAVANNA),Telangana Jaghir Party,1117,8,1125,S2916
1578,NOTA,None of the Above,6511,80,6591,S2916
1579,K. RAJASHEKAR BASAVARAJ HITNAL,Indian National Congress,661921,1590,663511,S108
1580,DR . BASAVARAJ. K. SHARANAPPA,Bharatiya Janata Party,614866,2288,617154,S108
1581,MALLIKARJUN HADAPAD,Independent,7310,4,7314,S108
1582,SHANKARA,Bahujan Samaj Party,7031,12,7043,S108
1583,KARADI BASAVARAJ,Independent,5868,9,5877,S108
1584,RUKMINI,Independent,5279,3,5282,S108
1585,SURESH. GOUDA MUNDINAMANE,Independent,4641,1,4642,S108
1586,NAGARAJ KALAL,Independent,1992,2,1994,S108
1587,KALAPPA YACHRAPPA BADIGER VISHWAKARMA,Independent,1967,15,1982,S108
1588,PA.YA. GANESH,Independent,1892,3,1895,S108
1589,HANAMESH . S . H. SHAKHAPUR,Independent,1247,1,1248,S108
1590,KAREEMPASHA GACHCHINMANI.,Independent,1233,5,1238,S108
1591,ANNOJI RAO. G,Sarva Janata Party,1113,4,1117,S108
1592,SHARANAPPA,Socialist Unity Centre Of India (COMMUNIST),1097,9,1106,S108
1593,NIRUPADI K GOMARSI,Karnataka Rashtra Samithi,891,9,900,S108
1594,RAMZANBEE,All India Ulama Congress,800,6,806,S108
1595,D DURGA PRASAD BYATARAYANAJI,Challengers Party,798,1,799,S108
1596,C. SHARANA BASAPPA,Republican Party of India (Karnataka),770,6,776,S108
1597,IMAMSAB JANGLISAB MULLA,Independent,728,5,733,S108
1598,NOTA,None of the Above,3496,23,3519,S108
1599,GODAM NAGESH,Bharatiya Janata Party,558936,9232,568168,S291
1600,ATHRAM SUGUNA,Indian National Congress,472333,5183,477516,S291
1601,ATHRAM SAKKU,Bharat Rashtra Samithi,136463,837,137300,S291
1602,MALOTHU SYAMLAL NAYAK,Alliance of Democratic Reforms Party,7489,10,7499,S291
1603,MESRAM JANGUBAPU,Bahujan Samaj Party,6689,55,6744,S291
1604,RATHOD SUBASH,Independent,6434,94,6528,S291
1605,BUKYA JAIVANTH RAO,Independent,6427,19,6446,S291
1606,CHAVAN SUDHARSHAN,Anna YSR Congress Party,4618,26,4644,S291
1607,GANGADEVI MESRAM,Dharma Samaj Party,3445,23,3468,S291
1608,N. TIRUPATI,Vidhyarthula Rajakiya Party,2284,8,2292,S291
1609,KODAPA VAMAN RAO,Gondwana Dandkaranya Party,1677,8,1685,S291
1610,GEDAM. SAGAR,India Praja Bandhu Party,1537,8,1545,S291
1611,NOTA,None of the Above,11650,112,11762,S291
1612,DR.KALANIDHI VEERASWAMY,Dravida Munnetra Kazhagam,495733,1600,497333,S222
1613,R. MANOHAR,All India Anna Dravida Munnetra Kazhagam,157631,480,158111,S222
1614,R.C. PAUL KANAGARAJ,Bharatiya Janata Party,112628,690,113318,S222
1615,AMUDINI,Naam Tamilar Katchi,95715,239,95954,S222
1616,SARAH FATHIMA,Independent,5899,24,5923,S222
1617,E. IQBAL,Bahujan Samaj Party,3471,15,3486,S222
1618,MOORTHY. V,Independent,3131,6,3137,S222
1619,SURIYAMUTHU,Independent,976,2,978,S222
1620,C. SENAPATHI,Independent,850,0,850,S222
1621,DILLI GANESH. E,Independent,735,1,736,S222
1622,U. VENKATESH,Independent,709,5,714,S222
1623,M. ZION RAJ,Independent,696,1,697,S222
1624,A. AJITHKUMAR,Thakkam Katchi,671,2,673,S222
1625,J. SEBASTIN,Socialist Unity Centre Of India (COMMUNIST),586,2,588,S222
1626,AKSHAY,Naadaalum Makkal Katchi,563,3,566,S222
1627,B. BALAMURUGAN,Independent,485,3,488,S222
1628,K.PALANIAPPAN,Independent,460,2,462,S222
1629,R. SENTHIL KUMAR,Independent,457,0,457,S222
1630,MATHANKUMAR. G,Independent,390,0,390,S222
1631,P. JAYASELAN,Independent,386,0,386,S222
1632,M. KOLANJI,Independent,361,1,362,S222
1633,B. ZAKIR HUSSAIN,Independent,354,1,355,S222
1634,P. UMADEVI,Independent,346,0,346,S222
1635,K.C.JAYAPRAKASH,Independent,334,0,334,S222
1636,C. SRIDHAR,Independent,307,0,307,S222
1637,T. MANOHARAN,Independent,293,0,293,S222
1638,K. SAMPATH,Independent,268,1,269,S222
1639,D. SRINIVASAN,Independent,260,1,261,S222
1640,S. RAVIKUMAR,Republican Party of India  (Sivaraj),258,1,259,S222
1641,T. KAVIYARASU,Independent,250,2,252,S222
1642,SATHISH. B,Independent,245,1,246,S222
1643,R.VINAYAGAMOORTHY,Independent,206,0,206,S222
1644,D. KABILAN,Independent,203,6,209,S222
1645,P. MARIMUTHU,Independent,171,1,172,S222
1646,V.MADHAN MOHAN,Independent,163,0,163,S222
1647,NOTA,None of the Above,13139,69,13208,S222
1648,DR. MAHESH SHARMA,Bharatiya Janata Party,855413,2416,857829,S2413
1649,DR. MAHENDRA SINGH NAGAR,Samajwadi Party,297697,660,298357,S2413
1650,RAJENDRA SINGH SOLANKI,Bahujan Samaj Party,250962,653,251615,S2413
1651,BHIM PRAKASH JIGYASU,Viro Ke Vir Indian Party,3873,2,3875,S2413
1652,MOHD. MUMTAJ AALAM,Independent,2818,3,2821,S2413
1653,SHIVAM ASHUTOSH,Independent,2637,4,2641,S2413
1654,MANISH KUMAR DWIVEDI,Akhil Bhartiya Parivar Party,1769,3,1772,S2413
1655,KISHOR SINGH,National Party,1739,28,1767,S2413
1656,MAHKAR SINGH,Independent,1118,6,1124,S2413
1657,KM. SHALU,Loktantrik Janshakti Party,1020,30,1050,S2413
1658,PARAG KAUSHIK,Independent,945,1,946,S2413
1659,NARESH NAUTIYAL,Bhartiya Rashtriya Jansatta,931,10,941,S2413
1660,RAN SINGH DUDEE,Super Power India Party,905,3,908,S2413
1661,RAJEEV MISHRA,Jai Hind National Party,642,15,657,S2413
1662,NARAVEDASHVAR,Subhashwadi Bhartiya Samajwadi Party (Subhas Party),615,2,617,S2413
1663,NOTA,None of the Above,10286,38,10324,S2413
1664,PRIYANKA SATISH JARKIHOLI,Indian National Congress,710823,2638,713461,S101
1665,ANNASAHEB SHANKAR JOLLE,Bharatiya Janata Party,618168,4459,622627,S101
1666,KALLOLIKAR SHAMBHU KRISHNA,Independent,25351,115,25466,S101
1667,SAMMED SARADAR VARDHAMANE,Independent,5351,2,5353,S101
1668,SHRENIK ANNASAHEB JANGATE,Independent,5179,2,5181,S101
1669,APPASAHEB SHRIPATI KURANE,Sarva Janata Party,4635,19,4654,S101
1670,VILAS MANNUR,Independent,4143,7,4150,S101
1671,SATTEPPA DASHARATH KALELI,Bharatheeya Jawan Kisan Party,1304,15,1319,S101
1672,YASIN SHIRAJUDDIN PATAKI,Independent,1279,2,1281,S101
1673,KASHINATH KALLAPPA KURANI,Independent,1097,11,1108,S101
1674,MAHESH ASHOK KASAR,Independent,1002,7,1009,S101
1675,MOHAN GURAPPA MOTANNAVAR,Independent,938,8,946,S101
1676,KUMAR SAMBHAJI DONGARE,Karnataka Rashtra Samithi,930,11,941,S101
1677,PAVANKUMAR BABURAV MALAGE,Bahujan Bharat Party,655,11,666,S101
1678,DR|| KADAYYA HIREMATH (SWAMIJI),Independent,642,5,647,S101
1679,BHIMASEN DATTU SANADI,Independent,614,5,619,S101
1680,GAJANAN L. PUJARI,Independent,591,9,600,S101
1681,JITENDRA SUBHASH NERLE,Independent,452,5,457,S101
1682,NOTA,None of the Above,2571,37,2608,S101
1683,DINESH CHANDRA YADAV,Janata Dal  (United),639758,891,640649,S0413
1684,DA KUMAR CHANDRADEEP,Rashtriya Janata Dal,464982,1133,466115,S0413
1685,SURESHWAR PODDAR,Aadarsh Mithila Party,15423,11,15434,S0413
1686,MD ARSHAD HUSSAIN,Bahujan Samaj Party,12947,44,12991,S0413
1687,JAWAHAR LAL JAISWAL,Socialist Unity Centre Of India (COMMUNIST),11320,2,11322,S0413
1688,UCHESHWAR PANDIT,Samajhdar Party,11127,22,11149,S0413
1689,PRO KAMESHWAR YADAV,Bharatiya Jan Kranti Dal (Democratic),10665,9,10674,S0413
1690,AJABLAL MEHTA,Yuva Krantikari Party,8720,16,8736,S0413
1691,NOTA,None of the Above,32557,68,32625,S0413
1692,KALYAN VAIJINATHRAO KALE,Indian National Congress,605504,2393,607897,S1318
1693,DANVE RAOSAHEB DADARAO,Bharatiya Janata Party,495809,2130,497939,S1318
1694,MANGESH SANJAY SABLE,Independent,155335,595,155930,S1318
1695,BAKALE PRABHAKAR DEVGAN,Vanchit Bahujan  Aaghadi,37678,132,37810,S1318
1696,BABASAHEB SANTUKRAO SHELKE,Samata Party,9564,6,9570,S1318
1697,CHABUKSWAR RAHUL NIRANJAN,Independent,6330,7,6337,S1318
1698,NIVRUTTI VISHWNATH BANSODE,Bahujan Samaj Party,5974,34,6008,S1318
1699,DIPAK BHIMRAO BORHADE,Samnak Janta Party,5498,24,5522,S1318
1700,TANAJI TUKARAM BHOJANE,Independent,4933,15,4948,S1318
1701,KAMBLE MAROTI DASHARATH,Independent,3712,16,3728,S1318
1702,RAJENDRA NAMDEO MAGRE,Independent,2873,2,2875,S1318
1703,MANOJ NEMINATH KOLTE,Independent,2734,3,2737,S1318
1704,MUKESH PRABHAT RATHOD,Akhil Bhartiya Parivar Party,2580,11,2591,S1318
1705,BABASAHEB PATIL SHINDE,Independent,2413,4,2417,S1318
1706,KADUBA MHATARBA INGLE,Independent,1962,5,1967,S1318
1707,AJHAR ANWAR SAYYAD,Independent,1541,5,1546,S1318
1708,AHMAD RAHIM SAIKH BAGWAN,Independent,1390,4,1394,S1318
1709,ADV. YOGESH DATTU GULLAPELLI,Independent,1339,3,1342,S1318
1710,BHAGWAN SAHEBRAO REGUDE,Hindustan Janta Party,1173,1,1174,S1318
1711,DNYANESHWAR DAGDUJI NADE,Independent,1142,1,1143,S1318
1712,DHANANJAY RUPRAOJI KAKDE (PATIL),Bharatheeya Jawan Kisan Party,1132,7,1139,S1318
1713,ABDUL RAFIQ ABDUL LATIF,Independent,1045,2,1047,S1318
1714,SHYAM RUSTUMRAO SHIRSATH,Bahujan Republican  Socialist Party,972,2,974,S1318
1715,RATAN ASARAM LANDGE,Independent,646,1,647,S1318
1716,VIKAS CHHAGAN LAHANE,Independent,644,0,644,S1318
1717,SHAM PAWALS RUPEKAR,Independent,544,2,546,S1318
1718,NOTA,None of the Above,3504,33,3537,S1318
1719,PROF S P SINGH BAGHEL,Bharatiya Janata Party,597061,2336,599397,S2418
1720,SURESH CHAND KARDAM,Samajwadi Party,326644,1459,328103,S2418
1721,POOJA AMROHI,Bahujan Samaj Party,175810,664,176474,S2418
1722,ARAM SINGH,Peoples Party of India (Democratic),4130,13,4143,S2418
1723,KULDEEP KUMAR,Bharatiya Kisan Parivartan Party,1997,5,2002,S2418
1724,MAHENDRA SINGH,Independent,1779,6,1785,S2418
1725,POOJA,Independent,1363,7,1370,S2418
1726,SARVESH KUMAR,Bharatiya Majdoor Janta Party,1123,10,1133,S2418
1727,AMBEDAKARI HASANURAM AMBEDAKARI,Independent,927,6,933,S2418
1728,JITENDRA GAUTAM,Lokpriya Rashtrawadi Party,780,2,782,S2418
1729,CHANDRA PAL,Adarsh Samaj Party,640,3,643,S2418
1730,NOTA,None of the Above,6929,85,7014,S2418
1731,G. KUMAR NAIK.,Indian National Congress,669413,1553,670966,S106
1732,RAJA AMARESHWARA NAIK.,Bharatiya Janata Party,588833,2352,591185,S106
1733,S. NARASANNA GOUDA NAYAKA,Bahujan Samaj Party,9275,14,9289,S106
1734,BASAVA PRABHU. MEDA,Karnataka Rashtra Samithi,5173,8,5181,S106
1735,AMARESH,Independent,4459,6,4465,S106
1736,YALLAMMA DALAPATHI,Independent,3629,5,3634,S106
1737,MEDHAR SHAMRAO,Bhartiya Jan Samrat Party,2625,15,2640,S106
1738,RAMALINGAPPA,Socialist Unity Centre Of India (COMMUNIST),2404,5,2409,S106
1739,NOTA,None of the Above,9825,25,9850,S106
1740,RAHUL GANDHI,Indian National Congress,642299,5146,647445,S114
1741,ANNIE RAJA,Communist Party of India,280594,2429,283023,S114
1742,K SURENDRAN,Bharatiya Janata Party,139868,1177,141045,S114
1743,P.R KRISHNANKUTTY,Bahujan Samaj Party,1946,27,1973,S114
1744,SATHYAN K.P,Independent,1017,42,1059,S114
1745,SINOJ A.C,Independent,885,18,903,S114
1746,PRASEETHA AZHIKODE,Independent,814,26,840,S114
1747,AJEEB MUHAMMED,Independent,796,8,804,S114
1748,P RADHAKRISHNAN,Independent,555,7,562,S114
1749,NOTA,None of the Above,6932,67,6999,S114
1750,ALFRED KANNGAM S ARTHUR,Indian National Congress,381813,3141,384954,S142
1751,KACHUI TIMOTHY ZIMIK,Naga Peoples Front,298358,1178,299536,S142
1752,S KHO JOHN,Independent,89677,233,89910,S142
1753,ALYSON ABONMAI,Independent,14865,245,15110,S142
1754,NOTA,None of the Above,6530,695,7225,S142
1755,ANURAG SINGH THAKUR,Bharatiya Janata Party,593055,14013,607068,S083
1756,SATPAL RAIZADA,Indian National Congress,414828,9883,424711,S083
1757,HEM RAJ,Bahujan Samaj Party,2694,64,2758,S083
1758,JAGDEEP KUMAR,Rashtriya Devbhumi Party,1738,26,1764,S083
1759,SURENDER KUMAR GAUTAM,Independent,1401,9,1410,S083
1760,SUBEDAR MAJOR KULWANT SINGH PATIAL,Bharatheeya Jawan Kisan Party,1176,63,1239,S083
1761,NAND LAL,Independent,978,41,1019,S083
1762,SUMIT RANA,Akhil Bhartiya Parivar Party,666,9,675,S083
1763,RAMESH CHAND SARTHI,Independent,544,16,560,S083
1764,ARUN ANKESH SYAL,Ekam Sanatan Bharat Dal,412,21,433,S083
1765,GARIB DASS KATOCH,Independent,210,36,246,S083
1766,GOPI CHAND ATTARI,Independent,168,34,202,S083
1767,NOTA,None of the Above,5100,78,5178,S083
1768,DR JAYANTA KUMAR ROY,Bharatiya Janata Party,763236,3332,766568,S253
1769,NIRMAL CHANDRA ROY,All India Trinamool Congress,677496,2379,679875,S253
1770,DEBRAJ BARMAN,Communist Party of India  (Marxist),73629,463,74092,S253
1771,SHIPRA RAY HAKIM,Independent,9890,17,9907,S253
1772,BINOD MALLICK,Bahujan Samaj Party,8537,29,8566,S253
1773,HAREKRISHNA SARKAR,Independent,5837,11,5848,S253
1774,MAHESWAR BARMAN,Independent,4254,13,4267,S253
1775,RAM PRASAD MANDAL,Socialist Unity Centre Of India (COMMUNIST),3815,20,3835,S253
1776,MANABENDRA ROY,Kamatapur People’s Party (United),2899,51,2950,S253
1777,NIRODE CHANDRA ADHIKARY,Independent,2504,13,2517,S253
1778,ADHIR CHANDRA BARMAN,Independent,1911,16,1927,S253
1779,RANJIT BARMAN,Mulnibasi Party of India,1180,9,1189,S253
1780,NOTA,None of the Above,16807,41,16848,S253
1781,DR RANI SRI KUMAR,Dravida Munnetra Kazhagam,423025,2654,425679,S2237
1782,DR K KRISHNASAMY,All India Anna Dravida Munnetra Kazhagam,228290,1190,229480,S2237
1783,B JOHN PANDIAN,Bharatiya Janata Party,206982,1843,208825,S2237
1784,ESAI MATHIVANAN,Naam Tamilar Katchi,128750,1585,130335,S2237
1785,KARPAGAVALLI P,Independent,6200,114,6314,S2237
1786,T MAHESHKUMAR,Bahujan Samaj Party,3526,28,3554,S2237
1787,RAMASAMY P,Viro Ke Vir Indian Party,3395,17,3412,S2237
1788,M MANMATHAN,Independent,3276,2,3278,S2237
1789,A SEETHA,Bahujan Dravida Party,2476,0,2476,S2237
1790,KRISHNASAMY,Independent,1828,5,1833,S2237
1791,M UMAMAHESWARI,Desiya Makkal Sakthi Katchi,1626,29,1655,S2237
1792,A MUTHAIAH,Independent,1440,17,1457,S2237
1793,P KRISHNASAMY,Independent,1342,8,1350,S2237
1794,ARUMUGASWAMI M,Independent,1292,21,1313,S2237
1795,RAJA SEKAR,Independent,982,11,993,S2237
1796,NOTA,None of the Above,16877,288,17165,S2237
1797,DR. PRASHANT YADAORAO PADOLE,Indian National Congress,581678,5735,587413,S1311
1798,SUNIL BABURAO MENDHE,Bharatiya Janata Party,546222,3811,550033,S1311
1799,KUMBHALKAR SANJAY BHAIYY,Bahujan Samaj Party,25104,358,25462,S1311
1800,SANJAY GAJANAN KEWAT,Vanchit Bahujan  Aaghadi,24528,330,24858,S1311
1801,SEWAKBHAU NIRDHAN WAGHAYE,Independent,12899,204,13103,S1311
1802,AJAYKUMAR BHARTIYA,Akhil Bhartiya Parivar Party,3998,59,4057,S1311
1803,SUMIT VIJAY PANDE,Independent,3719,0,3719,S1311
1804,VIRENDRAKUMAR KASTURCHAND JAISWAL,Independent,2382,7,2389,S1311
1805,DEVILAL SUKHRAM NEPALE,Peoples Party of India (Democratic),2000,9,2009,S1311
1806,DR. AKASH MADHUKAR JIBHAKATE,Independent,1972,9,1981,S1311
1807,VILAS BABURAO LENDE,Lok Swarajya Party,1624,25,1649,S1311
1808,VILAS JIYALAL RAUT,Independent,1611,5,1616,S1311
1809,BENIRAM RAMCHAND FULBANDHE,Independent,1482,15,1497,S1311
1810,PRADEEP  DHOBALE,Independent,1163,33,1196,S1311
1811,SURYAKIRAN ISHWAR NANDAGAWALI,Independent,1132,30,1162,S1311
1812,ITWALE SHARAD MARTAND,Independent,1020,8,1028,S1311
1813,TULSIRAM URKUDA GEDAM,Independent,831,11,842,S1311
1814,CHAITRAM DASHARATH KOKASE,Independent,780,11,791,S1311
1815,NOTA,None of the Above,10106,162,10268,S1311
1816,DHARAMBIR SINGH,Bharatiya Janata Party,582735,5929,588664,S078
1817,RAO DAN SINGH,Indian National Congress,541926,5228,547154,S078
1818,BAHADUR SINGH,Jannayak Janta Party,15076,189,15265,S078
1819,SUNIL KUMAR SHARMA,Bahujan Samaj Party,6239,97,6336,S078
1820,SUBHASH,Rashtrawadi Janlok Party (Satya),4663,32,4695,S078
1821,HEMANT,Independent,3876,5,3881,S078
1822,SEEMA,Independent,2961,18,2979,S078
1823,VED PRAKASH,Independent,1897,3,1900,S078
1824,ANAND KUMAR,Bharatheeya Jawan Kisan Party,1642,26,1668,S078
1825,YOGBIR SINGH,Independent,1473,5,1478,S078
1826,VARSHA,Independent,993,60,1053,S078
1827,BALWAN,Peoples Party of India (Democratic),854,3,857,S078
1828,ROHTASH,Socialist Unity Centre Of India (COMMUNIST),637,3,640,S078
1829,JAI SINGH,Independent,442,9,451,S078
1830,BHARAT BHUSHAN,Bhartiya Shakti Chetna Party,440,3,443,S078
1831,ENGINEER MAHAVIR SINGH YADAV,Independent,406,9,415,S078
1832,JAGDISH,Independent,219,10,229,S078
1833,NOTA,None of the Above,5188,99,5287,S078
1834,KODIKUNNIL SURESH,Indian National Congress,362209,7307,369516,S1116
1835,ADV ARUN KUMAR C A,Communist Party of India,352708,5940,358648,S1116
1836,BAIJU KALASALA,Bharath Dharma Jana Sena,140830,2154,142984,S1116
1837,C MONICHEN,Independent,4893,81,4974,S1116
1838,SANTHOSH PALATHUMPADAN,Bahujan Samaj Party,4183,123,4306,S1116
1839,SURESH NOORANAD,Ambedkarite Party of India,1441,64,1505,S1116
1840,K BIMALJI,Socialist Unity Centre Of India (COMMUNIST),1336,34,1370,S1116
1841,MANTHARA VELAYUDHAN,Independent,910,19,929,S1116
1842,KOZHUVASSERIL SURESH,Independent,836,20,856,S1116
1843,NOTA,None of the Above,9640,243,9883,S1116
1844,RUDRA NARAYAN PANY,Bharatiya Janata Party,593907,4814,598721,S189
1845,ABINASH SAMAL,Biju Janata Dal,520144,2010,522154,S189
1846,SASHMITA BEHERA,Indian National Congress,34052,678,34730,S189
1847,PRAFULLA KUMAR NAIK,Bahujan Samaj Party,4850,45,4895,S189
1848,MAHESWAR SAHOO,Independent,4614,15,4629,S189
1849,MANASI SWAIN,Socialist Unity Centre Of India (COMMUNIST),3376,8,3384,S189
1850,PRIYABRATA GARNAIK,Independent,2904,5,2909,S189
1851,JANARDAN NAIK,Independent,2647,6,2653,S189
1852,KAILAS CHANDRA PRADHAN,Independent,2205,8,2213,S189
1853,SWAPNA RANI JAMES,Utkal Samaj,1603,5,1608,S189
1854,NOTA,None of the Above,13731,46,13777,S189
1855,SUDHEER GUPTA,Bharatiya Janata Party,942249,3512,945761,S1223
1856,DILIP SINGH GURJAR,Indian National Congress,443622,1484,445106,S1223
1857,KANHAIYALAL MALVIYA,Bahujan Samaj Party,10456,56,10512,S1223
1858,ISMAIL KHAN MAIV,Independent,8810,16,8826,S1223
1859,SUSHIL,Independent,3432,7,3439,S1223
1860,SAEED AHAMAD,Independent,3165,2,3167,S1223
1861,MURALIDHAR,Independent,2682,14,2696,S1223
1862,VIJAY RANN,Independent,2314,9,2323,S1223
1863,NOTA,None of the Above,11615,47,11662,S1223
1864,RAJIV PRATAP RUDY,Bharatiya Janata Party,470234,1518,471752,S0420
1865,ROHINI ACHARYA,Rashtriya Janata Dal,456763,1328,458091,S0420
1866,LAXAMAN PRAO YADAV,Independent,22041,2,22043,S0420
1867,SHAK NAUSHAD,Independent,16101,2,16103,S0420
1868,AVINASH KUMAR,Bahujan Samaj Party,14708,62,14770,S0420
1869,RAGHWENDRA PRATAP SINGH,Independent,5165,2,5167,S0420
1870,GAJENDRA PRASAD CHAURSIYA,Janhit Kisan Party,5025,5,5030,S0420
1871,SHATRUDHAN TIWARY,Bhartiya Sarthak Party,3661,26,3687,S0420
1872,MOHAMAD SALIM,Independent,3148,3,3151,S0420
1873,ARTI KUMARI,Independent,3009,14,3023,S0420
1874,PRABHAT KUMAR,Independent,2302,4,2306,S0420
1875,BARUN KUMAR DAS,Gana Suraksha Party,1770,5,1775,S0420
1876,GYANI KUMAR SHARMA,Bharatiya Ekta Dal,1699,5,1704,S0420
1877,RAJESH KUSHWAHA,Bhartiya Lok Chetna Party,1486,3,1489,S0420
1878,NOTA,None of the Above,11382,35,11417,S0420
1879,GENIBEN NAGAJI THAKOR,Indian National Congress,667072,4811,671883,S062
1880,DR. REKHABEN HITESHBHAI CHAUDHARI,Bharatiya Janata Party,635760,5717,641477,S062
1881,MANSUNGBHAI MASHRUBHAI PARMAR,Bahujan Samaj Party,9900,29,9929,S062
1882,RATHOD MAVJI BHEMAJI,Independent,7690,6,7696,S062
1883,SHRIMALI ASHOKBHAI BALCHANDBHAI,Independent,5473,8,5481,S062
1884,JASUBHAI GAMAR,Bharat Adivasi Party,4615,11,4626,S062
1885,PATEL PIYUSHBHAI KARSHANBHAI,Bharatiya Yuva Jan Ekta Party,3503,10,3513,S062
1886,BAJAG LASHABHAI LAVAJIBHAI,Independent,2994,15,3009,S062
1887,PRAVINBHAI ISHVARBHAI CHAUHAN,Swatantrata Abhivyakti Party,1822,1,1823,S062
1888,IBRAHIMBHAI PARASANI,Independent,1588,3,1591,S062
1889,PARMAR CHHAGANCHANDRARAJ,Independent,1369,5,1374,S062
1890,CHETANKUMAR KESHAVLAL OZA,Independent,1321,13,1334,S062
1891,NOTA,None of the Above,22034,133,22167,S062
1892,DR. RICKY ANDREW J. SYNGKON,Voice of the People Party,569156,1922,571078,S151
1893,VINCENT H. PALA,Indian National Congress,198045,1123,199168,S151
1894,DR. MAZEL AMPAREEN LYNGDOH,National People's Party,185531,957,186488,S151
1895,ROBERTJUNE KHARJAHRIN,United Democratic Party,44278,285,44563,S151
1896,PROF. LAKHON KMA,Independent,18522,60,18582,S151
1897,PETER SHALLAM,Independent,6975,49,7024,S151
1898,NOTA,None of the Above,10944,64,11008,S151
1899,K. C VENUGOPAL,Indian National Congress,398246,6314,404560,S1115
1900,A. M ARIFF,Communist Party of India  (Marxist),335596,5451,341047,S1115
1901,SOBHA SURENDRAN,Bharatiya Janata Party,295841,3807,299648,S1115
1902,MURALEEDHARAN KONCHERILLAM,Bahujan Samaj Party,1578,48,1626,S1115
1903,ARJUNAN,Socialist Unity Centre Of India (COMMUNIST),1301,18,1319,S1115
1904,VAYALAR RAJEEVAN,Bahujan Dravida Party,674,1,675,S1115
1905,ADV.K.M SHAJAHAN,Independent,627,55,682,S1115
1906,SHAJAHAN V.A.     S/O ABDUL AZEES,Independent,553,23,576,S1115
1907,SATHEESH SHENOI,Independent,473,9,482,S1115
1908,JAYAKRISHNAN P,Independent,329,56,385,S1115
1909,JYOTHI ABRAHAM,Independent,328,10,338,S1115
1910,NOTA,None of the Above,7252,113,7365,S1115
1911,ROOP KUMARI CHOUDHARY,Bharatiya Janata Party,701291,2368,703659,S269
1912,TAMRADHWAJ SAHU,Indian National Congress,556764,1439,558203,S269
1913,PROFESSOR SURESH SAHU,Independent,11885,3,11888,S269
1914,BASANT SINHA,Bahujan Samaj Party,8823,37,8860,S269
1915,REKHRAM BAGH,Independent,7877,1,7878,S269
1916,GANESH RAM DHRUW,Hamar Raj Party,6626,25,6651,S269
1917,SANTOSH DARCHAND BANJARE,Independent,6049,5,6054,S269
1918,MUKESH KUMAR AGRAWAL,Independent,3689,2,3691,S269
1919,SUKHNANDAN  DESHKAR,Independent,3554,1,3555,S269
1920,NITESH KUMAR RATRE,Sunder Samaj Party,2366,7,2373,S269
1921,DR. VIRENDRA CHAUDHRI,Bhartiya Shakti Chetna Party,2093,6,2099,S269
1922,KALIYA PRASAD SETH,Independent,1528,3,1531,S269
1923,MAHESH SWARN,Independent,1484,2,1486,S269
1924,CHAMPA LAL PATEL GURUJI DHARTI PAKD,Right to Recall Party,1376,3,1379,S269
1925,FARID QURAISHI,Gondvana Gantantra Party,1074,3,1077,S269
1926,ISHWAR MARKANDE,Independent,957,0,957,S269
1927,NARAD PRASAD NISHAD,Shakti Sena (Bharat Desh),897,2,899,S269
1928,NOTA,None of the Above,3801,39,3840,S269
1929,KHAN SAUMITRA,Bharatiya Janata Party,677320,2810,680130,S2537
1930,SUJATA MONDAL,All India Trinamool Congress,671148,3415,674563,S2537
1931,SITAL CHANDRA KAIBARTYA,Communist Party of India  (Marxist),104895,516,105411,S2537
1932,SADANANDA MANDAL,Socialist Unity Centre Of India (COMMUNIST),16046,28,16074,S2537
1933,JOYDEV DHANK,Bahujan Samaj Party,9027,52,9079,S2537
1934,BASUDEB SIKARI,Independent,5093,13,5106,S2537
1935,NARENDRANATH RAY,Independent,4360,17,4377,S2537
1936,NOTA,None of the Above,19062,70,19132,S2537
1937,SHANTANU THAKUR,Bharatiya Janata Party,716952,2553,719505,S2514
1938,BISWAJIT DAS S/O LATE BIJAY KRISHNA DAS,All India Trinamool Congress,643653,2159,645812,S2514
1939,PRADIPKUMAR BISWAS,Indian National Congress,64859,317,65176,S2514
1940,DIPAK MAJUMDAR,All India Secular Front,19199,17,19216,S2514
1941,SUJATA BAIRAGI,Independent,9649,4,9653,S2514
1942,JASHAJIT SARKHEL,Independent,7829,4,7833,S2514
1943,CHANDAN MALLICK,Bahujan Samaj Party,5905,30,5935,S2514
1944,PRANITA MANDAL,Independent,2407,4,2411,S2514
1945,SUMITA PODDAR,Independent,2347,7,2354,S2514
1946,BISWAJIT DAS S/O LATE BALARAM DAS,Independent,2241,7,2248,S2514
1947,PATIT PABAN MANDAL,Socialist Unity Centre Of India (COMMUNIST),2140,29,2169,S2514
1948,SAMARESH BISWAS,Party for Democratic Socialism,1562,3,1565,S2514
1949,BISWAJIT DAS,Independent,1257,15,1272,S2514
1950,KALYAN SARKAR,Independent,676,15,691,S2514
1951,SUBRATA BISWAS,Guruchand Sena Dal,581,2,583,S2514
1952,NOTA,None of the Above,6635,50,6685,S2514
1953,BUNTY VIVEK SAHU,Bharatiya Janata Party,643489,1249,644738,S1216
1954,NAKUL KAMALNATH,Indian National Congress,529931,1189,531120,S1216
1955,DEVIRAM URF DEV RAVEN BHALAVI,Gondvana Gantantra Party,55854,134,55988,S1216
1956,UMAKANT BANDEWAR,Bahujan Samaj Party,11802,21,11823,S1216
1957,KAPIL SONI,Rashtriya Gondvana Party,9634,4,9638,S1216
1958,SIRAJ SHEKH,Independent,9567,1,9568,S1216
1959,PAWANSHAH SARYAM,Independent,6612,9,6621,S1216
1960,SUBHASH SHUKLA,Independent,5768,1,5769,S1216
1961,RAJENDRA DONGRE,Independent,4628,4,4632,S1216
1962,GOVIND BHALAVI,Independent,4022,7,4029,S1216
1963,MOHD. PARVEZ QURESHI,Independent,3818,10,3828,S1216
1964,AJAY BARKADE,Independent,2491,4,2495,S1216
1965,KUSHWAHA RAJESH TANTRIK,Ahinsa Samaj Party,1695,3,1698,S1216
1966,""" PRAKASH ALIAS BANTY "" PARTETI",Rashtra Samarpan Party,1652,2,1654,S1216
1967,FOGAL BANSOD,Republican Party of India (A),1322,1,1323,S1216
1968,NOTA,None of the Above,9887,16,9903,S1216
1969,ADV ADOOR PRAKASH,Indian National Congress,323273,4778,328051,S1119
1970,V JOY,Communist Party of India  (Marxist),321715,5652,327367,S1119
1971,V  MURALEEDHARAN,Bharatiya Janata Party,307710,4069,311779,S1119
1972,SURABHI S,Bahujan Samaj Party,4485,39,4524,S1119
1973,PRAKASH P L,Independent,1762,52,1814,S1119
1974,SANTHOSH K,Independent,1146,58,1204,S1119
1975,PRAKASH S,Independent,745,66,811,S1119
1976,NOTA,None of the Above,9681,110,9791,S1119
1977,GOPINATH K,Indian National Congress,491131,1752,492883,S229
1978,JAYAPRAKASH V,All India Anna Dravida Munnetra Kazhagam,299300,1097,300397,S229
1979,NARASIMHAN C,Bharatiya Janata Party,212859,1266,214125,S229
1980,VIDHYA RANI,Naam Tamilar Katchi,106260,823,107083,S229
1981,ARUMUGAM M,Bharatiya Praja Aikyata Party,6118,36,6154,S229
1982,DR.SHANMUGAM .A.R,Independent,5577,6,5583,S229
1983,ESHWARAN C,Independent,4126,2,4128,S229
1984,TAMILSELVAN S,Bahujan Samaj Party,3665,33,3698,S229
1985,SWAMINATHAN T G,Aravor Munnetra Kazhagam,1969,9,1978,S229
1986,MANI K,Chennai Youth Party,1964,8,1972,S229
1987,SRINIVASAN K,Independent,1619,2,1621,S229
1988,VENKATESHKUMAR M,Independent,1585,5,1590,S229
1989,ALBERT FRANCIS XAVIER S,Independent,1422,1,1423,S229
1990,SARAVANAKUMAR A,Independent,1163,6,1169,S229
1991,ANAND KUMAR A,Independent,1157,3,1160,S229
1992,SUBRAMANI M,Tamilar Makkal Katchi,1156,39,1195,S229
1993,ANNADURAI K,Independent,1154,6,1160,S229
1994,MAHARAJAN G,Independent,991,4,995,S229
1995,JAGADHEESAN C,Viro Ke Vir Indian Party,897,3,900,S229
1996,VIJAYAKUMAR K P,Anaithu India Makkal Katchi,891,46,937,S229
1997,DEEKSHITH M,Karunaadu Party,817,7,824,S229
1998,RAMESH A,Independent,816,3,819,S229
1999,RAJESHWARI B.H.,Independent,793,6,799,S229
2000,CHANDRAMOHAN K.M.,Independent,789,3,792,S229
2001,DEVAPPA Y,Independent,717,7,724,S229
2002,VEERASAMY C,Independent,656,4,660,S229
2003,YUVARAJ K P U,Independent,402,3,405,S229
2004,NOTA,None of the Above,10893,89,10982,S229
2005,CAPTAIN BRIJESH CHOWTA,Bharatiya Janata Party,760130,4002,764132,S1017
2006,PADMARAJ.R.POOJARY,Indian National Congress,612103,2821,614924,S1017
2007,KANTHAPPA ALANGAR,Bahujan Samaj Party,4202,30,4232,S1017
2008,DURGA PRASAD,Karunada Sevakara Party,2578,14,2592,S1017
2009,SUPREETH KUMAR POOJARY  KATEEL,Independent,1884,17,1901,S1017
2010,MAXIM PINTO,Independent,1654,36,1690,S1017
2011,PRAJAAKEEYA MANOHARA,Uttama Prajaakeeya Party,964,7,971,S1017
2012,DEEPAK RAJESH COELHO,Independent,950,26,976,S1017
2013,RANJINI. M,Karnataka Rashtra Samithi,758,18,776,S1017
2014,NOTA,None of the Above,23515,61,23576,S1017
2015,SANJAY UTTAMRAO DESHMUKH,Shiv Sena (Uddhav Balasaheb Thackrey),591899,2908,594807,S1314
2016,RAJSHRITAI HEMANT PATIL (MAHALLE),Shiv Sena,498514,1820,500334,S1314
2017,ANIL JAYRAM RATHOD,Samnak Janta Party,56175,215,56390,S1314
2018,HARISING (HARIBHAU) NASARU RATHOD,Bahujan Samaj Party,17256,140,17396,S1314
2019,SANGITA DINESH CHAVHAN,Independent,7169,11,7180,S1314
2020,RAMDAS BAJIRAO GHODAM,Independent,6776,5,6781,S1314
2021,VINOD PANJABRAO NANDAGAVALI,Independent,6291,7,6298,S1314
2022,SANDIP SAMPAT SHINDE,Independent,5511,3,5514,S1314
2023,DHARAM DILIPSING THAKUR,Sanman Rajkiya Paksha,4539,16,4555,S1314
2024,AMOL KOMAWAR,Hindrashtra Sangh,3364,13,3377,S1314
2025,UTTAM ONKAR INGOLE,Peoples Party of India (Democratic),2958,17,2975,S1314
2026,MANOJ MAHADEORAO GEDAM,Independent,2783,11,2794,S1314
2027,NUR ALI MAHEBUB ALI SHAH,Independent,1951,7,1958,S1314
2028,DR ARJUNKUMAR SITARAM RATHOD,Independent,1857,6,1863,S1314
2029,PRO KISAN RAMRAO AMBURE,Independent,1705,15,1720,S1314
2030,DIKSHANT NAMDEVRAO SAWAIKAR,Independent,1095,8,1103,S1314
2031,GOKUL PREMDAS CHAVHAN,Independent,1091,3,1094,S1314
2032,NOTA,None of the Above,9316,75,9391,S1314
2033,CHANDAN CHAUHAN,Rashtriya Lok Dal,402604,1889,404493,S244
2034,DEEPAK,Samajwadi Party,366226,759,366985,S244
2035,VIJENDER SINGH,Bahujan Samaj Party,218294,692,218986,S244
2036,ABDUL BARI,Jai Samta Party,8046,26,8072,S244
2037,DEEPAK KUMAR,Independent,7284,34,7318,S244
2038,ZAHEER,Independent,2780,8,2788,S244
2039,RAJAPAL,Peoples Party of India (Democratic),2361,12,2373,S244
2040,MOHD. SHAHJAD,Independent,2342,5,2347,S244
2041,FARMAN,Majloom Samaj Party,2334,9,2343,S244
2042,CHANDAN SINGH,Independent,2132,44,2176,S244
2043,RAMDHAN SINGH,Majdoor Kisan Union Party,2088,17,2105,S244
2044,NOTA,None of the Above,4386,60,4446,S244
2045,CHANDRA PRAKASH CHOUDHARY,AJSU Party,447896,3243,451139,S276
2046,MATHURA PRASAD MAHATO,Jharkhand Mukti Morcha,367197,3062,370259,S276
2047,JAIRAM KUMAR MAHATO,Independent,342241,5081,347322,S276
2048,KAMAL PRASAD,Bahujan Samaj Party,13971,103,14074,S276
2049,SUBODH KUMAR YADAV,Independent,13093,13,13106,S276
2050,RAMESHWAR DUSADH,Independent,11011,9,11020,S276
2051,SUNITA TUDU,Independent,10899,45,10944,S276
2052,MD AINUL ANSARI,Bahujan Mukti Party,6919,20,6939,S276
2053,DWARAKA PRASAD LALA,Independent,5617,10,5627,S276
2054,KALAWATI DEVI,Independent,5414,16,5430,S276
2055,GYANESHWAR PRASAD,Lokhit Adhikar Party,5348,8,5356,S276
2056,SHIVJI PRASAD,Right to Recall Party,4248,6,4254,S276
2057,PRAMOD RAM,Peoples Party of India (Democratic),3805,20,3825,S276
2058,USHA SINGH,Independent,3703,58,3761,S276
2059,PAPPU KUMAR NISHAD,Bhartiya Lokmat Rashtrwadi Party,3203,13,3216,S276
2060,SUBHASH KUMAR THAKUR,Sarv Samaj Party,2513,4,2517,S276
2061,NOTA,None of the Above,5927,117,6044,S276
2062,RAJA A,Dravida Munnetra Kazhagam,470729,2483,473212,S2219
2063,DR MURUGAN L,Bharatiya Janata Party,231111,1516,232627,S2219
2064,LOGESH TAMILSELVAN D,All India Anna Dravida Munnetra Kazhagam,219417,813,220230,S2219
2065,JAYAKUMAR A,Naam Tamilar Katchi,58588,233,58821,S2219
2066,VIJAYAKUMAR D,Independent,4805,3,4808,S2219
2067,GANESHAMOORTHI A,Bahujan Samaj Party,3015,18,3033,S2219
2068,BADRAN M,Ganasangam Party of India,2406,19,2425,S2219
2069,SELVAN N,Independent,2038,16,2054,S2219
2070,DHANABAL R,Independent,1906,22,1928,S2219
2071,JAYANTHI M,Ambedkarite Party of India,1539,17,1556,S2219
2072,MURUGAN Y,Independent,1408,5,1413,S2219
2073,MURUGESAN,Independent,1057,2,1059,S2219
2074,MALARMANNAN M,Samaniya Makkal Nala Katchi,813,7,820,S2219
2075,SATHISH M,Independent,734,6,740,S2219
2076,KRISHNA KUMAR,Independent,588,27,615,S2219
2077,ANBHUGURU V,Independent,560,5,565,S2219
2078,NOTA,None of the Above,12902,98,13000,S2219
2079,MOHITE-PATIL DHAIRYASHEEL RAJSINH,Nationalist Congress Party – Sharadchandra Pawar,618566,3647,622213,S1343
2080,RANJEETSINGH HINDURAO NAIK NIMBALKAR,Bharatiya Janata Party,499171,2205,501376,S1343
2081,ER. RAMCHANDRA MAYAPPA GHUTUKADE,New Rashtriya Samaj Party,58344,77,58421,S1343
2082,BARASKAR RAMESH NAGNATH,Vanchit Bahujan  Aaghadi,20519,85,20604,S1343
2083,JANKAR SWARUP DADA,Bahujan Samaj Party,7036,58,7094,S1343
2084,HAKE LAXMAN SOPAN,Independent,5083,51,5134,S1343
2085,SITARAM VITTHAL RANDIVE,Independent,4980,6,4986,S1343
2086,DHANAJI SHRIPATI MASKE,Independent,4433,0,4433,S1343
2087,BICHUKALE SANTOSH BALASAHEB,Republican Party of India (A),4039,7,4046,S1343
2088,SAWANT RAHUL SHASHIKANT,Independent,3903,6,3909,S1343
2089,AWARE SIDDHESHWAR BHARAT,All India Forward Bloc,3058,9,3067,S1343
2090,HANUMANT NARAYAN MANE,Independent,2862,2,2864,S1343
2091,NANDU SAMBHAJI MORE,Independent,2686,1,2687,S1343
2092,NAVANATH BIRA MADANE,Independent,2434,1,2435,S1343
2093,GIRISH PRABHAKAR SHETE,Independent,2380,3,2383,S1343
2094,ADV. JORE SACHIN BHASKAR,Independent,2344,3,2347,S1343
2095,NANASAHEB RAMHARI YADAV,Independent,2213,1,2214,S1343
2096,KIRAN TANAJI SATHE,Independent,2167,8,2175,S1343
2097,BHAUSAHEB SUKHADEV LIGADE,Independent,2034,18,2052,S1343
2098,ER. BALIRAM SUKHADEV MORE,Independent,1952,1,1953,S1343
2099,KHARAT SANDIP JANARADHAN,Independent,1746,9,1755,S1343
2100,NARAYAN TATOBA KALEL,Independent,1557,3,1560,S1343
2101,KASHINATH KISAN DEOKATE,Independent,1276,3,1279,S1343
2102,GOPAL YESHVANT JADHAV,Bharatheeya Jawan Kisan Party,1273,16,1289,S1343
2103,SATYAWAN VIJAY OMBASE,Swarajya Sena (Maharashtra),1254,6,1260,S1343
2104,SITAPURE VINOD DILIP,Independent,1190,1,1191,S1343
2105,ASHOK DNYANDEV WAGHMODE,Independent,984,5,989,S1343
2106,ANIL BHAGAVAN SHEDAGE,Independent,977,5,982,S1343
2107,AMOL MADHUKAR KARADE,Independent,900,3,903,S1343
2108,RASHID ISMAIL SHAIKH,Independent,842,1,843,S1343
2109,MORE ROHIT RAMKRUSHNA,Independent,669,2,671,S1343
2110,SARADE GANESH NAVNATH,Independent,598,3,601,S1343
2111,NOTA,None of the Above,3655,47,3702,S1343
2112,BHARTRUHARI MAHTAB,Bharatiya Janata Party,529271,2330,531601,S1814
2113,SANTRUPT MISRA,Biju Janata Dal,473443,1081,474524,S1814
2114,SURESH MOHAPATRA,Indian National Congress,83461,354,83815,S1814
2115,PRAMOD KUMAR MALLICK,Bahujan Samaj Party,4461,23,4484,S1814
2116,NIRANJAN PATI,Independent,4390,6,4396,S1814
2117,SOBHA PANDEY,Independent,3878,10,3888,S1814
2118,PRAKASH CHANDRA SAHOO,Krupaa Party,3790,4,3794,S1814
2119,RAJAKISHORE MALLIK,Socialist Unity Centre Of India (COMMUNIST),3072,3,3075,S1814
2120,GOKULANANDA MISHRA,Independent,1804,4,1808,S1814
2121,MINATI PATNAIK,Samruddha Odisha,1241,10,1251,S1814
2122,NOTA,None of the Above,8130,29,8159,S1814
2123,SANTOSH PANDEY,Bharatiya Janata Party,711439,618,712057,S266
2124,BHUPESH BAGHEL,Indian National Congress,667078,568,667646,S266
2125,A.H. SIDDIQUI,Independent,10737,0,10737,S266
2126,DEVLAL SINHA (SONVANSHI),Bahujan Samaj Party,9659,9,9668,S266
2127,NARAD PRASAD NISHAD,Shakti Sena (Bharat Desh),8029,1,8030,S266
2128,SUKHDEV SINHA,Independent,7998,3,8001,S266
2129,VISHESH DHAMGAYE,Independent,4872,1,4873,S266
2130,BHUVAN SAHU,Independent,4171,3,4174,S266
2131,LALITA KANWAR,Hamar Raj Party,2139,10,2149,S266
2132,ER. BASANT KUMAR MESHRAM,Independent,1818,2,1820,S266
2133,RAMESH RAJPUT,Bhartiya Shakti Chetna Party,1735,2,1737,S266
2134,TRIVENI PADOTI,Independent,1607,6,1613,S266
2135,RAMFAL PATIL,Nyaydharmsabha,1535,2,1537,S266
2136,AJAY PALI,Independent,1114,0,1114,S266
2137,LAKHAN SING TANDAN,Rashtriya Jansabha Party,1056,0,1056,S266
2138,NOTA,None of the Above,9152,401,9553,S266
2139,S SUPONGMEREN JAMIR,Indian National Congress,399512,2439,401951,S171
2140,DR CHUMBEN MURRY,Nationalist Democratic Progressive Party,350072,895,350967,S171
2141,HAYITHUNG TUNGOE LOTHA,Independent,6050,182,6232,S171
2142,NOTA,None of the Above,1520,126,1646,S171
2143,JADHAV PRATAPRAO GANPATRAO,Shiv Sena,348289,1578,349867,S135
2144,NARENDRA DAGDU KHEDEKAR,Shiv Sena (Uddhav Balasaheb Thackrey),319415,973,320388,S135
2145,RAVIKANT CHANDRADAS TUPKAR,Independent,249042,921,249963,S135
2146,VASANTRAO RAJARAM MAGAR,Vanchit Bahujan  Aaghadi,98093,348,98441,S135
2147,ASHOK WAMAN HIWALE,Independent,15414,22,15436,S135
2148,SANDEEP RAMRAO SHELKE,Independent,12993,57,13050,S135
2149,GAUTAM KISANRAO MAGHADE,Bahujan Samaj Party,8125,93,8218,S135
2150,ASLAM SHAH HASAN SHAH,Maharashtra Vikas Aghadi,6117,36,6153,S135
2151,NANDU JAGANNATH LAWANGE,Independent,5696,17,5713,S135
2152,MACHHINDRA SHESHRAV MAGHADE,Socialist Party (India),5247,11,5258,S135
2153,MOHAMMAD HASAN INAMDAR,Minorities Democratic Party,4966,12,4978,S135
2154,GAJANAN JANARDAN DHANDE,Independent,4841,13,4854,S135
2155,DINKAR TUKARAM SAMBARE,Independent,4550,14,4564,S135
2156,BALASAHEB RAMCHANDRA INGLE,Independent,3911,20,3931,S135
2157,PRATAP PANDHARINATH PATIL,Independent,2547,14,2561,S135
2158,SANTOSH BHIMRAO INGLE,Republican Party of India (A),2524,6,2530,S135
2159,MADHAVRAO SAKHARAM BANSODE,Bahujan Republican  Socialist Party,2441,14,2455,S135
2160,VIKAS BHAI NANDAVE,Bhim Sena,2322,9,2331,S135
2161,UDDHAV ONKAR ATOLE,Independent,1946,22,1968,S135
2162,REKHA KAILAS POPHALKAR,Independent,1533,7,1540,S135
2163,PROF SUMANTAI TIRPUDE,Peoples Party of India (Democratic),1505,6,1511,S135
2164,NOTA,None of the Above,3750,36,3786,S135
2165,GADDIGOUDAR. PARVATAGOUDA. CHANDANAGOUDA.,Bharatiya Janata Party,667441,3598,671039,S103
2166,SAMYUKTA SHIVANAND PATIL,Indian National Congress,600741,1899,602640,S103
2167,NAGARAJ. S. KALKUTAGAR,Independent,5628,1,5629,S103
2168,PARASHURAM. LAXMAN. NEELANAIK,Independent,5084,6,5090,S103
2169,ANTHOSH SAVVASE,Uttama Prajaakeeya Party,4909,14,4923,S103
2170,JYOTI GULEDGUDDA,Independent,4636,9,4645,S103
2171,M. B. SIDAGONI,Bahujan Samaj Party,4453,26,4479,S103
2172,DR. MUTTU. S. SURAKOD. (MADAR),Independent,3131,4,3135,S103
2173,PRASHANT RAO,Independent,1909,5,1914,S103
2174,DATTATREYA DASHARATHA TAVARE,Independent,1607,13,1620,S103
2175,AMBROSE D' MELLO,Independent,1203,2,1205,S103
2176,KENGANAL. MALLIKARJUN. BHIMAPPA,Independent,1189,18,1207,S103
2177,MALLIKARJUN H. T.,Socialist Unity Centre Of India (COMMUNIST),1137,7,1144,S103
2178,RAJESAB BURANSAB. MASALI,Independent,988,4,992,S103
2179,SHARANAPPA MALLAPPA KOTLANNAVAR,Independent,830,2,832,S103
2180,RAVI SHIVAPPA PADASALAGI,Independent,654,2,656,S103
2181,SAIYYAD IMAMSAB JAKALI,Tipu Sultan Party,546,4,550,S103
2182,ABDULAZIZ KALADAGI PENDARI,Independent,524,5,529,S103
2183,MUTTAPPA MUDAKAPPA HIREKUMBI,Raita Bharat Party,509,9,518,S103
2184,SAGAR. BASAPPA. KUMBAR,Karnataka Rashtra Samithi,494,5,499,S103
2185,S. M. MARIGOUDAR,Desh Prem Party,451,3,454,S103
2186,SHANKAR. VENKAPPA. NAIKAR.,Republican Party of India (A),431,10,441,S103
2187,NOTA,None of the Above,3398,22,3420,S103
2188,SHRIMANT CHH UDAYANRAJE PRATAPSINHAMAHARAJ BHONSLE,Bharatiya Janata Party,568749,2385,571134,S1345
2189,SHASHIKANT JAYVANTRAO SHINDE,Nationalist Congress Party – Sharadchandra Pawar,536475,1888,538363,S1345
2190,GADE SANJAY KONDIBA,Independent,37035,27,37062,S1345
2191,KADAM PRASHANT RAGHUNATH,Vanchit Bahujan  Aaghadi,11878,34,11912,S1345
2192,ANAND RAMESH THORWADE,Bahujan Samaj Party,6432,53,6485,S1345
2193,KORDE SURESHRAO DINKAR,Independent,4699,13,4712,S1345
2194,MARUTI DHONDIRAM JANKAR,Independent,3944,7,3951,S1345
2195,SEEMA SUNIL POTDAR,Independent,3458,0,3458,S1345
2196,VISHWAJIT PATIL UNDALKAR,Independent,3432,6,3438,S1345
2197,NIVRUTTI KERU SHINDE,Independent,2666,8,2674,S1345
2198,SAYAJI GANPAT WAGHMARE,Bahujan Republican  Socialist Party,2490,11,2501,S1345
2199,SACHIN SUBHASH MAHAJAN,Independent,2010,5,2015,S1345
2200,DR ABHIJEET WAMANRAO AWADE BICHUKALE,Independent,1388,7,1395,S1345
2201,TUSHAR VIJAY MOTLING,Bahujan Mukti Party,1296,5,1301,S1345
2202,PRATIBHA SHELAR,Independent,1104,19,1123,S1345
2203,BAGAL SADASHIV SAHEBRAO,Independent,955,3,958,S1345
2204,NOTA,None of the Above,5476,46,5522,S1345
2205,SMITA UDAY WAGH,Bharatiya Janata Party,672119,2309,674428,S133
2206,KARAN BALASAHEB PATIL - PAWAR,Shiv Sena (Uddhav Balasaheb Thackrey),421213,1621,422834,S133
2207,YUVRAJ JADHAV (SAMBHA AAPPA),Vanchit Bahujan  Aaghadi,21062,115,21177,S133
2208,EX-HAVILDAR ISHWAR DAYARAM MORE,Sainik Samaj Party,7479,69,7548,S133
2209,VILAS SHANKAR TAYADE,Bahujan Samaj Party,6310,71,6381,S133
2210,LALIT (BANTI) SHARMA,Independent,4189,3,4192,S133
2211,KARAN PAWAR,Independent,3954,29,3983,S133
2212,ADVOCATE VIJAY BABULAL DANEJ,Independent,3400,4,3404,S133
2213,MUKESH MULCHAND KOLI,Independent,3358,12,3370,S133
2214,MAHENDRA DEVRAM KOLI,Independent,2462,14,2476,S133
2215,AHMAD KHAN,Independent,1889,12,1901,S133
2216,ABDUL SHAKUR DESHPANDE,Independent,1593,13,1606,S133
2217,ADV. NAMDEO PANDURANG KOLI,Independent,1212,12,1224,S133
2218,PATIL SANDIP YUVRAJ,Independent,1098,12,1110,S133
2219,NOTA,None of the Above,13878,41,13919,S133
2220,T.SUMATHY (ALIAS) THAMIZHACHI THANGAPANDIAN,Dravida Munnetra Kazhagam,515307,1321,516628,S223
2221,DR.TAMILISAI SOUNDARARAJAN,Bharatiya Janata Party,289229,1454,290683,S223
2222,DR.J.JAYAVARDHAN,All India Anna Dravida Munnetra Kazhagam,172108,383,172491,S223
2223,S.TAMILCHELVI,Naam Tamilar Katchi,83821,151,83972,S223
2224,M.G.RAMU,Jebamani Janata,3526,8,3534,S223
2225,M.AZARUTHEEN,Independent,1808,4,1812,S223
2226,G.P. ROBERT,Bahujan Samaj Party,1596,3,1599,S223
2227,R.RAVICHANDRAN,Independent,835,0,835,S223
2228,S.MANIMARAN,Independent,803,0,803,S223
2229,FARMER JAYARAMAN. S.K.J,Desiya Makkal Sakthi Katchi,790,2,792,S223
2230,A.K.D. ELLAPPAN,Mahathma Makkal Munnetra Kazhakam,761,0,761,S223
2231,K.KANNAN,Independent,625,0,625,S223
2232,BALAJI. G. MANGADU,Aravor Munnetra Kazhagam,588,1,589,S223
2233,KUTTIMANI. S,Veerath Thiyagi Viswanathadoss Thozhilalarkal Katchi,565,0,565,S223
2234,R.KANCHANA,Tamizhaga Murpokku Makkal Katchi,565,1,566,S223
2235,SASI REKHA,Naadaalum Makkal Katchi,557,2,559,S223
2236,P. SATHEESH KUMAR,Independent,520,1,521,S223
2237,P.SEKAR,Thakkam Katchi,435,0,435,S223
2238,R.YOGESHWARAN,Independent,425,1,426,S223
2239,J. SATHISH,Independent,418,0,418,S223
2240,V.P. RAVIKKARAN,Independent,372,1,373,S223
2241,A.PONNUDURAI,Independent,362,0,362,S223
2242,N.V.DAMODARAN,National Maha Sabha Party,341,2,343,S223
2243,M.MUNUSWAMY,Viro Ke Vir Indian Party,326,4,330,S223
2244,KARTHIK MURTHY,Independent,312,3,315,S223
2245,V.P.SURESH,Independent,288,1,289,S223
2246,E.RAMESH,Independent,270,0,270,S223
2247,R.BALAJI,Independent,264,0,264,S223
2248,DINESH KUMAR. B,Independent,253,0,253,S223
2249,A.BABU,Independent,246,0,246,S223
2250,DAYALAN. R,Independent,241,1,242,S223
2251,VIJIRATHINAM. M,Independent,237,0,237,S223
2252,V.SIVAKUMAR,Independent,217,0,217,S223
2253,MURUGAN. P,Independent,182,0,182,S223
2254,G.RAMESHBABU,Independent,178,1,179,S223
2255,S.RAJASEKARAN,Independent,177,1,178,S223
2256,N.NARAYANASWAMY,Independent,175,0,175,S223
2257,R.DEVENDRAN,Independent,167,1,168,S223
2258,PARTHIBAN. S,Independent,165,1,166,S223
2259,I. DAVIDSINGH,Independent,150,1,151,S223
2260,E RAVENDRAN,Independent,114,0,114,S223
2261,NOTA,None of the Above,15607,46,15653,S223
2262,YADUVEER KRISHNADATTA CHAMARAJA WADIYAR,Bharatiya Janata Party,790391,5112,795503,S1021
2263,M. LAKSHMANA,Indian National Congress,653739,2502,656241,S1021
2264,RANGASWAMY. M,Independent,4301,5,4306,S1021
2265,KADAMBA NAA AMBARISH,Karnataka Jantha Paksha,4069,11,4080,S1021
2266,A. S. SATHISH,Independent,3736,10,3746,S1021
2267,RAMAMURTHY. M,Independent,3601,4,3605,S1021
2268,RAJU,Independent,1940,9,1949,S1021
2269,PRAJAKEEYA LEELA SHIVAKUMAR,Uttama Prajaakeeya Party,1724,30,1754,S1021
2270,COMRADE SUNIL T. R,Socialist Unity Centre Of India (COMMUNIST),1538,22,1560,S1021
2271,H. K. KRISHNA,Karunaadu Party,1479,10,1489,S1021
2272,HARISH GOWDA,Socialist Party (India),967,9,976,S1021
2273,P. S. YADURAPPA,Independent,874,4,878,S1021
2274,AMBEDKAR. C. J,Independent,821,14,835,S1021
2275,DARSHAN K PONNETI,Independent,761,3,764,S1021
2276,M. S. PRAVEEN,Karnataka Rashtra Samithi,735,5,740,S1021
2277,CHRISTOPHER RAJ KUMAR,Independent,533,11,544,S1021
2278,DR. H. M. NANJUNDASWAMY,Samajwadi Janata Party(Karnataka),519,4,523,S1021
2279,A. G. RAMACHANDRA RAO,Secular Democratic Congress,487,3,490,S1021
2280,NOTA,None of the Above,4446,44,4490,S1021
2281,MURLIDHAR MOHOL,Bharatiya Janata Party,584171,557,584728,S1334
2282,DHANGEKAR RAVINDRA HEMRAJ,Indian National Congress,461409,281,461690,S1334
2283,VASANT (TATYA) MORE,Vanchit Bahujan  Aaghadi,31991,21,32012,S1334
2284,RANPISE PRASHANT DADARAM,Bahujan Samaj Party,3969,5,3974,S1334
2285,CHORMALE SANDIP SOPAN,Independent,1644,1,1645,S1334
2286,GORAKH NARAYAN GHODKE,Independent,1451,0,1451,S1334
2287,KIRAN LAXMAN RAYKAR,Independent,1052,0,1052,S1334
2288,ANIS ARASHID SUNDAKE,All India Majlis-E-Ittehadul Muslimeen,859,1,860,S1334
2289,SACHIN DATTATRAY DHANKUDE,Independent,788,1,789,S1334
2290,YUVRAJ CHANDRAKANT  LIMBOLE,Right to Recall Party,698,0,698,S1334
2291,DR. DEVYANI PANDIT,Independent,645,5,650,S1334
2292,NARENDRA DNYANESHWAR PAWTEKAR,Independent,533,1,534,S1334
2293,SAGAR SAMBHAJI PORE,Independent,515,0,515,S1334
2294,SURESH DNYANOBA PATIL,Sainik Samaj Party,437,0,437,S1334
2295,AMBORE MANJUNATH MARUTI,Independent,433,0,433,S1334
2296,ASHWINI PRATIBHA KHAIRNAR,Independent,412,3,415,S1334
2297,VIJAY VINAYAK JAGTAP,Independent,382,0,382,S1334
2298,HEMANT BABURAV KOLEKAR ALIAS HEMANT PATIL,Apni Prajahit Party,374,1,375,S1334
2299,NEERAJ SUNIL KAMTHAN,Hindu Samaj Party,351,0,351,S1334
2300,MANOJ LAXMAN VETAL,Bhim Sena,351,1,352,S1334
2301,KAMBLE MILIND,Bahujan Samaj Party  (Ambedkar),344,3,347,S1334
2302,CHANDRAKANT PARMESHWAR SAWANT,Independent,314,0,314,S1334
2303,SHABBIR SAJJANBHAI TAMBOLI,Independent,313,0,313,S1334
2304,SANJAY LAXMAN KENDALE,Independent,311,0,311,S1334
2305,JOHNSON VASANT KOLHAPURE,Independent,304,1,305,S1334
2306,ADV. YOGESH MAKANE,Independent,298,1,299,S1334
2307,SUBROTO ROY,Ekam Sanatan Bharat Dal,293,1,294,S1334
2308,DR. BALASAHEB ARJUN POL,Independent,259,0,259,S1334
2309,VIJAYALAXMI SHRIKANT SINDAGI,Rashtriya Maratha Party,239,1,240,S1334
2310,MAHESH DASHRATH MHASKE,Independent,229,2,231,S1334
2311,YABES ALIAS AMOL SHAMUVEL TUJARE,Independent,223,0,223,S1334
2312,VIJAY PANDURANGRAO DESHMUKH (DABADGAONKAR),Independent,183,2,185,S1334
2313,BABA SALIM SAYYED,Independent,163,1,164,S1334
2314,BAGBAN SALEEM ABDUL RAZZAQUE,Independent,146,0,146,S1334
2315,ZNYOSHO VIJAYPRAKASH,Independent,138,0,138,S1334
2316,NOTA,None of the Above,7449,11,7460,S1334
2317,SUKANTA MAJUMDAR,Bharatiya Janata Party,572925,2071,574996,S256
2318,BIPLAB MITRA,All India Trinamool Congress,563252,1358,564610,S256
2319,JOYDEV KUMAR SIDDHANTA,Revolutionary Socialist Party,54081,136,54217,S256
2320,HAKIM MURMU,Independent,6820,2,6822,S256
2321,BAKHTIAR MUJAHIT SAHANI,Independent,6391,2,6393,S256
2322,RANENDRA NATH MALI,Independent,5590,3,5593,S256
2323,ANTA HANSDA,Bahujan Samaj Party,5130,15,5145,S256
2324,BISWANATH MURMU,Ambedkarite Party of India,3454,11,3465,S256
2325,MOZAMMEL HAQUE,All India Secular Front,2261,7,2268,S256
2326,NAROTTAM SAHA,Independent,2095,11,2106,S256
2327,MD. SARWARDI,Bhumiputra United Party,1957,10,1967,S256
2328,BIRENDRA NATH MAHANTA,Socialist Unity Centre Of India (COMMUNIST),1380,7,1387,S256
2329,RUBEL SARKAR,Kamatapur People’s Party (United),898,4,902,S256
2330,NOTA,None of the Above,7430,7,7437,S256
2331,BHARAT SINGH KUSHWAH,Bharatiya Janata Party,668782,2753,671535,S123
2332,PRAVEEN PATHAK,Indian National Congress,599077,2248,601325,S123
2333,KALYAN SINGH KANSANA,Bahujan Samaj Party,33308,157,33465,S123
2334,ARCHANA SINGH RATHORE,Rashtriya Samaj Paksha,5873,19,5892,S123
2335,BHARAT PAL,Aazad Samaj Party (Kanshi Ram),4138,25,4163,S123
2336,ER. MAHENDRA PRATAP SINGH PAL,Independent,3777,6,3783,S123
2337,RAKESH DHAKAD,Independent,3218,2,3220,S123
2338,YASHDEV SHARMA,Independent,2568,3,2571,S123
2339,DEEPAK KUMAR BANSAL (RANG WALE),Independent,2448,0,2448,S123
2340,SHREE NARESH CHANDRA SHARMA,Independent,2215,1,2216,S123
2341,GAJENDRA SINGH,Independent,1343,5,1348,S123
2342,ANJALI MONU RAWAT,Parivartan Party of India,1272,7,1279,S123
2343,ADVOCATE MUKESH KUMAR KORI,Independent,1130,4,1134,S123
2344,RAM PRAKASH SINGH PAL,Rashtra Uday Party,1059,12,1071,S123
2345,CHANDAN RATHORE,Parivartan Samaj Party,1053,6,1059,S123
2346,DR. P. D. AGARWAL SR. MEDICAL CONSULTANT,Independent,1016,5,1021,S123
2347,AMIT PARIHAR,Independent,877,6,883,S123
2348,COMRADE RACHNA AGRAWAL,Socialist Unity Centre Of India (COMMUNIST),798,5,803,S123
2349,MUNESH NAGAR,Vikas India Party,667,5,672,S123
2350,NOTA,None of the Above,3309,32,3341,S123
2351,MUKESH RAJPUT,Bharatiya Janata Party,486925,1038,487963,S2440
2352,DR. NAVAL KISHOR SHAKYA,Samajwadi Party,484485,800,485285,S2440
2353,KRANTI PANDEY,Bahujan Samaj Party,45274,116,45390,S2440
2354,AMAR SINGH,Bharatiya Rashtriya Morcha,3345,13,3358,S2440
2355,HARNANDAN SINGH,Independent,2457,12,2469,S2440
2356,SHYAMVEER SINGH,Bharatiya Nagrik Party,2431,3,2434,S2440
2357,VIDYAPRAKASH,Bharatheeya Jawan Kisan Party,1456,11,1467,S2440
2358,DINESH,Bhartiya Shakti Chetna Party,1061,2,1063,S2440
2359,NOTA,None of the Above,4350,15,4365,S2440
2360,JASWANTSINH SUMANBHAI BHABHOR,Bharatiya Janata Party,685734,2981,688715,S0619
2361,DR. PRABHABEN KISHORSINH TAVIYAD,Indian National Congress,352238,2800,355038,S0619
2362,MEDA DEVENDRAKUMAR LAXMANBHAI,Independent,11068,7,11075,S0619
2363,BHABHOR DHULABHAI DITABHAI,Bahujan Samaj Party,8621,11,8632,S0619
2364,BARIYA MANILAL HIRABHAI,Independent,6576,12,6588,S0619
2365,DAMOR VESTABHAI JOKHANABHAI,Independent,4374,26,4400,S0619
2366,DAMOR MANABHAI BHAVSINGBHAI,Independent,3144,29,3173,S0619
2367,JAGDISHBHAI MANILAL MEDA,Bharatiya National Janata Dal,3053,9,3062,S0619
2368,PASAYA NAVALSINH MULABHAI,Saath Sahakar Vikas Party,2667,6,2673,S0619
2369,NOTA,None of the Above,34774,164,34938,S0619
2370,RAHUL GANDHI,Indian National Congress,686044,1605,687649,S2436
2371,DINESH PRATAP SINGH,Bharatiya Janata Party,296703,916,297619,S2436
2372,THAKUR PRASAD YADAV,Bahujan Samaj Party,21588,36,21624,S2436
2373,DILEEP SINGH,Akhil Bhartiya Apna Dal,8676,2,8678,S2436
2374,HORILAL,Independent,5397,2,5399,S2436
2375,SUDARSHAN RAM,Bhartiya Panchsheel Party,4343,2,4345,S2436
2376,HIND ROHITASH,Manavtawadi Samaj Party,3859,0,3859,S2436
2377,MO MOBIN,Apna Dal (Kamerawadi),2173,1,2174,S2436
2378,NOTA,None of the Above,7861,11,7872,S2436
2379,PANKAJ CHAUDHARY,Bharatiya Janata Party,590487,823,591310,S2463
2380,VIRENDRA CHAUDHARY,Indian National Congress,555045,814,555859,S2463
2381,MO MAUSME ALAM,Bahujan Samaj Party,32893,62,32955,S2463
2382,BRIJESH,Abhay Samaj Party,8575,8,8583,S2463
2383,CHHEDI MAJDOOR,Independent,3833,1,3834,S2463
2384,RAMPRIT,Independent,3028,1,3029,S2463
2385,SUNIL,Independent,2716,2,2718,S2463
2386,VINOD KUMAR PATEL,Sardar Patel Siddhant Party,2415,3,2418,S2463
2387,NOTA,None of the Above,9730,15,9745,S2463
2388,ALOK SHARMA,Bharatiya Janata Party,978285,2824,981109,S1219
2389,ADVOCATE ARUN SHRIVASTAVA,Indian National Congress,478698,912,479610,S1219
2390,BHANU PRATAP SINGH,Bahujan Samaj Party,13255,50,13305,S1219
2391,DEENDAYAL AHIRWAR URF DEENU BHAIYA,Independent,3639,2,3641,S1219
2392,JAY SINGH,Independent,2509,1,2510,S1219
2393,BHARTI YADAV,Independent,1833,6,1839,S1219
2394,ANKIT RAI,Independent,1100,1,1101,S1219
2395,DHANRAJ SHENDE,Republican Party of India (A),788,2,790,S1219
2396,AJAY KUMAR PATHAK,Chhatrapati Shivaji Bhartiya Garib Party,787,3,790,S1219
2397,MOHAMMAD ASHRAF,Independent,777,1,778,S1219
2398,BABULAL SEN,Moulik Adhikar Party,718,2,720,S1219
2399,SANJAY KUMAR SAROJ,Manav Samadhan Party,621,1,622,S1219
2400,BALRAM SINGH TAUMAR,Bhartiya Shakti Chetna Party,587,1,588,S1219
2401,RAMPRASAD PATEL,Kranti Janshakti Party,572,3,575,S1219
2402,MUDIT CHAURASIA,Akhil Bhartiya Aarakshit Samaj Party,541,3,544,S1219
2403,MUDIT BHATNAGAR,Socialist Unity Centre Of India (COMMUNIST),537,3,540,S1219
2404,R.K. MAHAJAN,Independent,527,2,529,S1219
2405,ABDUL TAHIR ADVOCATE (BABLU RAJNIKANT)  S/O SAEED PAHELWAN ANSARI,Bahujan Maha Party,473,0,473,S1219
2406,MAITHILI SHARAN GUPTA,Independent,447,1,448,S1219
2407,RAJESH KEER,Independent,427,0,427,S1219
2408,AKSHAY GOTHI,Parivartan Party of India,403,4,407,S1219
2409,HITENDRA SHAHARE (BABA),Independent,318,0,318,S1219
2410,NOTA,None of the Above,6573,48,6621,S1219
2411,DEEPENDER SINGH HOODA,Indian National Congress,778259,5319,783578,S077
2412,DR. ARVIND KUMAR SHARMA,Bharatiya Janata Party,435028,3252,438280,S077
2413,RAVINDER,Jannayak Janta Party,6209,41,6250,S077
2414,RAKESH SINGH,Rashtrawadi Janlok Party (Satya),2706,8,2714,S077
2415,BISHAMBAR KUMAR,Independent,2394,0,2394,S077
2416,KALAWATI,Independent,2135,15,2150,S077
2417,PARVEEN KUMAR,Independent,1927,1,1928,S077
2418,UDEVIR,Independent,1530,2,1532,S077
2419,VINOD KUMAR,Peoples Party of India (Democratic),805,4,809,S077
2420,ASHOK KUMAR,Independent,627,2,629,S077
2421,VISHESH BAMEL,Bharatiya Asha Party,613,5,618,S077
2422,JAIKARAN MANDAUTHI,Socialist Unity Centre Of India (COMMUNIST),600,7,607,S077
2423,JAGBIR SINGH,Bharatheeya Jawan Kisan Party,574,19,593,S077
2424,SATISH KUMAR,Independent,524,0,524,S077
2425,SURENDER,Aam Aadmi Parivartan Party,447,23,470,S077
2426,MANISHA,Independent,410,21,431,S077
2427,ARVIND KUMAR SHARMA,Independent,360,7,367,S077
2428,SATISH KUMAR,Ekam Sanatan Bharat Dal,359,4,363,S077
2429,ARVIND,Independent,330,0,330,S077
2430,ADVOCATE ADITYA DHANKHAR,Super Power India Party,275,12,287,S077
2431,MASTER RANDHIR SINGH,Independent,267,2,269,S077
2432,MANJEET,Independent,267,2,269,S077
2433,SANJAY,Independent,210,2,212,S077
2434,YOGESH SHARMA,Independent,190,0,190,S077
2435,VINAY,Independent,156,3,159,S077
2436,LALIT KUMAR,Independent,129,2,131,S077
2437,NOTA,None of the Above,2321,41,2362,S077
2438,AMAR SINGH,Indian National Congress,331324,1267,332591,S198
2439,GURPREET SINGH GP,Aam Aadmi Party,297439,950,298389,S198
2440,GEJJA RAM,Bharatiya Janata Party,127139,382,127521,S198
2441,BIKRAMJIT SINGH KHALSA,Shiromani Akali Dal,126461,269,126730,S198
2442,RAJ JATINDER SINGH,Shiromani Akali Dal (Amritsar)(Simranjit Singh Mann),43543,101,43644,S198
2443,KULWANT SINGH,Bahujan Samaj Party,20786,106,20892,S198
2444,PREM SINGH MOHANPUR,Independent,3784,8,3792,S198
2445,BAHAL SINGH,Aazad Samaj Party (Kanshi Ram),3097,7,3104,S198
2446,PARAMJIT SINGH,Independent,2159,8,2167,S198
2447,RULDA SINGH,Independent,1971,6,1977,S198
2448,PARKASH PETER,Independent,1463,2,1465,S198
2449,HARJINDER SINGH,Independent,1158,8,1166,S198
2450,KAMALJEET KAUR,Independent,888,11,899,S198
2451,HARGOBIND SINGH,Independent,722,9,731,S198
2452,NOTA,None of the Above,9097,91,9188,S198
2453,DIMPLE YADAV,Samajwadi Party,596710,1816,598526,S2421
2454,JAYVEER SINGH,Bharatiya Janata Party,375895,992,376887,S2421
2455,SHIV PRASAD YADAV,Bahujan Samaj Party,66697,117,66814,S2421
2456,SURESH CHANDRA,Independent,2366,8,2374,S2421
2457,NAND RAM BAGRI,Voters Party  International,1765,4,1769,S2421
2458,MANJU PAL,Bhartiya Shakti Chetna Party,1148,23,1171,S2421
2459,PRAMOD KUMAR,Independent,994,12,1006,S2421
2460,SUNIL KUMAR MISHRA,Sarva Samaj Janata Party,878,4,882,S2421
2461,NOTA,None of the Above,4570,12,4582,S2421
2462,SELVAM. G,Dravida Munnetra Kazhagam,582978,3066,586044,S226
2463,RAJASEKAR. E,All India Anna Dravida Munnetra Kazhagam,362991,1580,364571,S226
2464,JOTHI. V,Pattali Makkal Katchi,163792,1139,164931,S226
2465,SANTHOSH KUMAR. V,Naam Tamilar Katchi,109858,414,110272,S226
2466,ILAYARAJA. S,Bahujan Samaj Party,5243,21,5264,S226
2467,VENKATESAN. K,Independent,2798,9,2807,S226
2468,NARESH BHARATHI. S,Independent,2499,12,2511,S226
2469,ELANGOVAN. M,Independent,1874,7,1881,S226
2470,SURYA. A,Independent,1673,29,1702,S226
2471,RAMESH. S,Independent,1317,1,1318,S226
2472,SELVAM. T,Independent,1295,17,1312,S226
2473,NOTA,None of the Above,16811,154,16965,S226
2474,BIDYUT BARAN MAHATO,Bharatiya Janata Party,719891,6283,726174,S279
2475,SAMIR KUMAR MOHANTY,Jharkhand Mukti Morcha,459997,6395,466392,S279
2476,INDRA DEO PRASAD,Independent,8463,6,8469,S279
2477,ARUN MAHATO,Independent,7337,7,7344,S279
2478,ANAND MUKHI,Independent,6346,6,6352,S279
2479,PRANAV KUMAR MAHTO,Bahujan Samaj Party,6090,61,6151,S279
2480,BISHWANATH MAHATO,Independent,5226,105,5331,S279
2481,ANGAD MAHATO,Amra Bangalee,4898,27,4925,S279
2482,JUJHAR SOREN,Independent,4262,53,4315,S279
2483,SUKUMAR SOREN,Bharat Adivasi Party,3860,34,3894,S279
2484,DHARMU TUDU,Ambedkarite Party of India,3274,17,3291,S279
2485,JITENDRA SINGH,Independent,3159,8,3167,S279
2486,SANAKA MAHATO,Socialist Unity Centre Of India (COMMUNIST),3137,38,3175,S279
2487,MANOJ GUPTA,Lokhit Adhikar Party,2355,7,2362,S279
2488,SADHU CHARAN PAUL,Independent,2291,26,2317,S279
2489,SAURAV VISHNU,Independent,2234,30,2264,S279
2490,SHAIKH AKHIRUDDIN,Bahujan Maha Party,2099,9,2108,S279
2491,ASHOK KUMAR,Peoples Party of India (Democratic),2038,10,2048,S279
2492,MAHESH KUMAR,Right to Recall Party,1952,8,1960,S279
2493,G JAYRAM DAS,Independent,1927,4,1931,S279
2494,ARUN KUMAR SHARMA,Bhartiya Azad Sena,1797,4,1801,S279
2495,DOMAN CHANDRA BHAKAT,Bhagidari Party(P),1343,5,1348,S279
2496,BABLU PRASAD DANGI,Independent,1144,8,1152,S279
2497,GYAN SAGAR PRASAD,Independent,1043,1,1044,S279
2498,PARWATI KISKU,Independent,972,16,988,S279
2499,NOTA,None of the Above,7105,221,7326,S279
2500,PRAVEEN PATEL,Bharatiya Janata Party,451380,1220,452600,S2451
2501,AMAR NATH SINGH MAURYA,Samajwadi Party,446596,1672,448268,S2451
2502,JAGANNATH PAL,Bahujan Samaj Party,82375,211,82586,S2451
2503,MAHIMA PATEL,Apna Dal (Kamerawadi),4134,28,4162,S2451
2504,JILA JEET BHARTIY,Bahujan Awam Party,3294,5,3299,S2451
2505,SUNIL KUMAR PRAJAPATI,Bhagidari Party(P),3040,7,3047,S2451
2506,ENGG YOGESH KUSHWAHA,Pragatisheel Samaj Party,2768,3,2771,S2451
2507,AKHILESH TRIPATHI,Independent,2295,3,2298,S2451
2508,NAFIS AHAMAD,Independent,2145,2,2147,S2451
2509,DR NEERAJ,Independent,1702,8,1710,S2451
2510,SANJEEV KUMAR MISHRA,Yuva Vikas Party,1675,4,1679,S2451
2511,MUSHIR AHMAD SIDDIQUI,Peoples Party of India (Democratic),1505,1,1506,S2451
2512,SANGEETA YADAV,Subhashwadi Bhartiya Samajwadi Party (Subhas Party),1283,8,1291,S2451
2513,LALA RAM SAROJ,Prabuddhwadi Bahujan Morcha,1043,9,1052,S2451
2514,PRAMOD BHAI PATEL URF P K,Sardar Patel Siddhant Party,947,1,948,S2451
2515,NOTA,None of the Above,5445,15,5460,S2451
2516,IMRAN MASOOD,Indian National Congress,547383,584,547967,S241
2517,RAGHAV LAKHANPAL,Bharatiya Janata Party,482120,1305,483425,S241
2518,MAJID ALI,Bahujan Samaj Party,179994,359,180353,S241
2519,MOHD INAM,Akhil Bhartiya Parivar Party,5392,8,5400,S241
2520,SHABNAM,Independent,2370,3,2373,S241
2521,SHAHBAJ,Independent,1696,2,1698,S241
2522,RASHID KHAN,Independent,1227,3,1230,S241
2523,TASMEEM BANO,Independent,883,2,885,S241
2524,RAJKUMAR,Independent,807,6,813,S241
2525,KAMRAN,Independent,744,1,745,S241
2526,NOTA,None of the Above,4559,7,4566,S241
2527,DHANORKAR PRATIBHA SURESH ALIAS BALUBHAU,Indian National Congress,716635,1775,718410,S1313
2528,MUNGANTIWAR SUDHIR SACCHIDANAND,Bharatiya Janata Party,456943,1061,458004,S1313
2529,BELE RAJESH WARLUJI,Vanchit Bahujan  Aaghadi,21934,46,21980,S1313
2530,RAJENDRA HARISHCHANDRA RAMTEKE,Bahujan Samaj Party,9145,43,9188,S1313
2531,SANJAY NILKANTH GAWANDE,Independent,5087,1,5088,S1313
2532,DIWAKAR HARIJI URADE,Independent,3221,3,3224,S1313
2533,NAMDEO MANIKRAO SHEDMAKE,Gondvana Gantantra Party,2238,18,2256,S1313
2534,SEWAKDAS KAWDUJI BARKE,Peoples Party of India (Democratic),1997,1,1998,S1313
2535,AWACHIT SHAMRAO SAYAM,Janseva Gondwana Party,1886,20,1906,S1313
2536,MILIND PRALHAD DAHIWALE,Independent,1759,2,1761,S1313
2537,ASHOK RANAJI RATHOD,Jay Vidarbha Party,1660,10,1670,S1313
2538,VIKAS UTTAMRAO LASANTE,Sanman Rajkiya Paksha,1518,2,1520,S1313
2539,VIDYASAGAR KALIDAS KASARLAWAR,Bhim Sena,1426,0,1426,S1313
2540,VANITA JITENDRA RAUT,Akhil Bharatiya Manavata Paksha,1054,3,1057,S1313
2541,PURNIMA DILIP GHONMODE,Bahujan Republican  Socialist Party,967,6,973,S1313
2542,NOTA,None of the Above,10821,22,10843,S1313
2543,AMARSING TISSO,Bharatiya Janata Party,332440,2180,334620,S036
2544,J. I. KATHAR,Independent,185864,1153,187017,S036
2545,JOY RAM ENGLENG,Indian National Congress,123055,964,124019,S036
2546,JOHN BARNARD SANGMA,Gana Suraksha Party,11241,38,11279,S036
2547,JOTSON BEY,Autonomous State Demand Committee,9561,72,9633,S036
2548,NOTA,None of the Above,16127,132,16259,S036
2549,KAKOLI GHOSH DASTIDAR,All India Trinamool Congress,689513,2497,692010,S2517
2550,SWAPAN MAJUMDER,Bharatiya Janata Party,576024,1797,577821,S2517
2551,TAPAS BANERJEE,All India Secular Front,121355,85,121440,S2517
2552,SANJIB CHATTERJEE,All India Forward Bloc,99456,544,100000,S2517
2553,SMRITIKANA HAOLADAR,Bahujan Samaj Party,5759,28,5787,S2517
2554,SAIFUDDIN MONDAL,Independent,3823,4,3827,S2517
2555,SWAPAN MAJUMDAR,Independent,3083,2,3085,S2517
2556,S MUKHTAR AHMED,Independent,2639,8,2647,S2517
2557,SEFALI DEY,Bharatiya Nyay-Adhikar Raksha Party,2244,8,2252,S2517
2558,SADHAN GHOSH,Socialist Unity Centre Of India (COMMUNIST),2025,22,2047,S2517
2559,BIKASH SARKAR,Mulnibasi Party of India,1928,1,1929,S2517
2560,MOHAN LAL ADHIKARY,Independent,1850,14,1864,S2517
2561,NOTA,None of the Above,17834,58,17892,S2517
2562,MUKESHKUMAR CHANDRAKAANT DALAL ( Uncontested ),Bharatiya Janata Party,0,0,0,S0624
2563,AMAR SHARADRAO KALE,Nationalist Congress Party – Sharadchandra Pawar,530761,2345,533106,S138
2564,RAMDAS CHANDRABHAN TADAS,Bharatiya Janata Party,449599,1859,451458,S138
2565,DR. MOHAN RAMRAOJI  RAIKWAR,Bahujan Samaj Party,20653,142,20795,S138
2566,PROF. RAJENDRA GULABRAO  SALUNKHE,Vanchit Bahujan  Aaghadi,15408,84,15492,S138
2567,ASIF,Independent,15176,6,15182,S138
2568,KISHOR BABA PAVAR,Independent,12917,3,12920,S138
2569,SUHAS V. THAKARE,Independent,7639,9,7648,S138
2570,AKSHAY MEHARE BHARTIYA,Akhil Bhartiya Parivar Party,5446,21,5467,S138
2571,MAROTI GULABRAO UIKE,Gondvana Gantantra Party,4651,21,4672,S138
2572,ADV. BHASKAR MAROTRAO  NEWARE,Independent,4021,11,4032,S138
2573,JAGADISH UDDVRAO  WANKHADE,Independent,2338,11,2349,S138
2574,POOJA PANKAJ TADAS,Independent,2121,14,2135,S138
2575,ANIL K. GHUSHE,Independent,1967,4,1971,S138
2576,ASHISH LEKHIRAM IZANKAR,Vidarbha Rajya Aghadi,1819,9,1828,S138
2577,VIJAY DNYANESHWARRAO  SHRIRAO,Independent,1723,15,1738,S138
2578,ARVIND SHAMRAO LILLORE,Independent,1475,1,1476,S138
2579,RAMRAO BAJIRAO GHODASKAR,All India Forward Bloc,1418,20,1438,S138
2580,KRUSHNA SUBHASHRAO FULKARI,Lok Swarajya Party,1342,1,1343,S138
2581,UMESH SOMAJI WAWARE,Maharashtra Vikas Aghadi,1231,15,1246,S138
2582,KRUSHNA ANNAJI KALODE,Hindrashtra Sangh,1052,9,1061,S138
2583,RAMESH SINHA,Independent,799,0,799,S138
2584,DR. MORESHWAR RAMJI NAGRALE,Republican Party of India,792,5,797,S138
2585,DIXITA ANAND,Desh Janhit Party,731,5,736,S138
2586,RAHUL T. BHOYAR,Independent,685,4,689,S138
2587,NOTA,None of the Above,4583,51,4634,S138
2588,AJAY KUMAR MANDAL,Janata Dal  (United),534923,1108,536031,S0426
2589,AJEET SHARMA,Indian National Congress,430025,1138,431163,S0426
2590,POONAM SINGH,Bahujan Samaj Party,12547,99,12646,S0426
2591,HARERAM YADAV,Independent,12255,3,12258,S0426
2592,DEEPAK KUMAR SINGH,Rashtriya Jansambhavna Party,7654,16,7670,S0426
2593,CHHOTE LAL KUMAR,Independent,6677,6,6683,S0426
2594,RAMESH TUDU,Independent,6629,5,6634,S0426
2595,UMESH PRASAD YADAV,Peoples Party of India (Democratic),5105,21,5126,S0426
2596,DEEPAK KUMAR,Socialist Unity Centre Of India (COMMUNIST),3758,5,3763,S0426
2597,MUKESH KUMAR,Akhil Bhartiya Parivar Party,3670,11,3681,S0426
2598,DAYARAM MANDAL,Lok Sewa Dal,3509,10,3519,S0426
2599,OM PRAKASH PODDAR,Independent,3091,13,3104,S0426
2600,NOTA,None of the Above,31771,32,31803,S0426
2601,KAMAKHYA PRASAD TASA,Bharatiya Janata Party,892766,4277,897043,S0310
2602,ROSELINA TIRKEY,Indian National Congress,646123,1973,648096,S0310
2603,DILUWARA BEGUM CHOWDHURY,Independent,11719,24,11743,S0310
2604,BINOD GOGOI,Independent,10625,54,10679,S0310
2605,ANIMA DEKA GUPTA,Voters Party  International,8641,32,8673,S0310
2606,TRIDIV JYOTI BHUYAN,Independent,8091,37,8128,S0310
2607,ABDUL HOQUE,Independent,6395,46,6441,S0310
2608,JYOTISKA RANJAN GOSWAMI,Independent,4494,44,4538,S0310
2609,SAILEN CH MALAKAR,Bharatiya Gana Parishad,3698,22,3720,S0310
2610,SALIM AHMED,Asom Jana Morcha,3243,23,3266,S0310
2611,SALEH AHMED MAZUMDAR,Republican Party of India (Athawale),3160,19,3179,S0310
2612,NOTA,None of the Above,24212,219,24431,S0310
2613,BHUPENDER YADAV,Bharatiya Janata Party,624110,7882,631992,S208
2614,LALIT YADAV,Indian National Congress,575964,7746,583710,S208
2615,FAZAL HUSSAIN,Bahujan Samaj Party,19178,109,19287,S208
2616,PARDEEP KUMAR,Sarv Samaj Party,4339,23,4362,S208
2617,VIVEK JAIN,Independent,2429,9,2438,S208
2618,RAMBABU SHARMA,Independent,2207,25,2232,S208
2619,AMIT GUPTA,Independent,1366,23,1389,S208
2620,CHHAGAN LAL,Independent,1291,36,1327,S208
2621,VISHVNATH KHINCHI,Hindustan Janta Party,862,17,879,S208
2622,NOTA,None of the Above,5727,95,5822,S208
2623,RODMAL NAGAR,Bharatiya Janata Party,756139,2604,758743,S1220
2624,DIGVIJAYA SINGH,Indian National Congress,610602,2052,612654,S1220
2625,DR. RAJENDRA SURYAVANSHI,Bahujan Samaj Party,13902,40,13942,S1220
2626,ASHOK PAWAR,Samata Samadhan Party,6597,17,6614,S1220
2627,JITENDRA SINGH,National World Leader Party,5051,12,5063,S1220
2628,DINESH RAZAWAT,Aazad Samaj Party (Kanshi Ram),4170,9,4179,S1220
2629,RODMAL,Independent,3733,11,3744,S1220
2630,ANIL JAIN,Independent,3069,20,3089,S1220
2631,RADHESHYAM MALVIYA,Independent,2796,3,2799,S1220
2632,SUNEEL BHEEL,Independent,2703,10,2713,S1220
2633,VISHAL SONI (ADVOCATE),Bharatiya Yuva Jan Ekta Party,2544,16,2560,S1220
2634,JAGDISH KARPENTER,Independent,1730,4,1734,S1220
2635,ANIL,Independent,1414,4,1418,S1220
2636,RAMCHARAN PIRJAPATI,Lok Samaj Party,1292,2,1294,S1220
2637,BABU SINGH,Sajag Samaj Party,1186,5,1191,S1220
2638,NOTA,None of the Above,7248,12,7260,S1220
2639,ASADUDDIN OWAISI,All India Majlis-E-Ittehadul Muslimeen,659278,2703,661981,S299
2640,MADHAVI LATHA KOMPELLA,Bharatiya Janata Party,320481,3413,323894,S299
2641,MOHAMMED WALIULLAH SAMEER,Indian National Congress,62497,465,62962,S299
2642,SRINIVAS YADAV GADDAM,Bharat Rashtra Samithi,18498,143,18641,S299
2643,MEKALA RAGHUMA REDDY,Yuga Thulasi Party,2231,1,2232,S299
2644,DR.J.PADMAJA,Viduthalai Chiruthaigal Katchi,899,1,900,S299
2645,K.S.KRISHNA,Bahujan Samaj Party,763,6,769,S299
2646,RAMESH KUMAR MATANGI,Sakala Janula Party,663,0,663,S299
2647,KRANTHI KUMAR BANDELA,Indian National Yuva Jana Party,561,1,562,S299
2648,M.JOHNSON,All India Mahila Empowerment Party,515,0,515,S299
2649,JAMEEL SAYED,Alliance of Democratic Reforms Party,492,0,492,S299
2650,ASHOK KUMAR MAMBA,Maa Telangana Party,422,1,423,S299
2651,DR.LUBNA SARWATH,Vidhyarthula Rajakiya Party,410,1,411,S299
2652,SARAF TULASI GUPTA,Praja Ektha Party,281,0,281,S299
2653,V.SHANKER,Yuva Taram Party,275,1,276,S299
2654,GADDAM HARISH GOUD,Dharma Samaj Party,269,2,271,S299
2655,SYED ANWAR,Independent,251,0,251,S299
2656,KHAJA MOINUDDIN,All India Majlis-E-Inquilab-E-Millat,233,1,234,S299
2657,AMJAD KHAN,Independent,195,1,196,S299
2658,AMBI HANUMANTH RAO,Socialist Party (India),161,1,162,S299
2659,SHAIK BASHA,Dalita Bahujana Party,153,0,153,S299
2660,M.K.AHMED,Independent,149,0,149,S299
2661,SALVERU RAMESH,Indian Praja Congress,141,0,141,S299
2662,L.ASHOKNATH,Telangana Prajaa Jeevana Rythu Party,141,0,141,S299
2663,J.SHYAMSUNDER RAO,Independent,138,0,138,S299
2664,ANDE USHA KANNA,Bahujan Mukti Party,133,0,133,S299
2665,SATTI SHABABU REDDY,Independent,123,0,123,S299
2666,ANIL SEN,Independent,111,0,111,S299
2667,CHAITANYA KUMAR REDDY PELLAKURU,Independent,110,0,110,S299
2668,SILIVERU NARESH,Telangana Jaghir Party,103,0,103,S299
2669,NOTA,None of the Above,2867,39,2906,S299
2670,BANDYOPADHYAY SUDIP,All India Trinamool Congress,453177,1519,454696,S2524
2671,TAPAS ROY,Bharatiya Janata Party,361268,868,362136,S2524
2672,PRADIP BHATTACHARYA,Indian National Congress,114556,426,114982,S2524
2673,DR. BIPLAB CHANDRA,Socialist Unity Centre Of India (COMMUNIST),3640,18,3658,S2524
2674,OMPRAKASH PRAJAPATI,Bahujan Samaj Party,3133,47,3180,S2524
2675,PRANATI PAUL,Independent,2267,5,2272,S2524
2676,SURENDRA KUMAR KABRA,Independent,1317,5,1322,S2524
2677,SWAPAN DAS,Independent,1163,3,1166,S2524
2678,MISBAHUS SALAM,Independent,975,6,981,S2524
2679,SAMPA GUHA,Bharatiya Nyay-Adhikar Raksha Party,912,4,916,S2524
2680,RAJKUMAR PALIT,Mission Naya Digant Party,768,4,772,S2524
2681,SMT. RINKU GUPTA,Pyramid Party of India,649,10,659,S2524
2682,AMAL KUMAR DEY,Independent,582,9,591,S2524
2683,ANUJIT KUMAR NAN,Independent,555,2,557,S2524
2684,BINOY KRISHNA CHATTERJEE,Independent,500,1,501,S2524
2685,NOTA,None of the Above,10004,40,10044,S2524
2686,RAJABHAU (PARAG) PRAKASH WAJE,Shiv Sena (Uddhav Balasaheb Thackrey),614517,2212,616729,S1321
2687,GODSE HEMANT TUKARAM,Shiv Sena,453414,1314,454728,S1321
2688,KARAN PANDHARINATH GAIKAR,Vanchit Bahujan  Aaghadi,47114,79,47193,S1321
2689,SHANTIGIRIJI MAUNGIRIJI MAHARAJ,Independent,44415,109,44524,S1321
2690,ARUN MADHUKAR KALE,Bahujan Samaj Party,7698,53,7751,S1321
2691,CHANDRAKANT KESHAVRAO THAKUR,Independent,6607,1,6608,S1321
2692,AMOL SAMPATRAO KAMBLE,Rashtriya Kisan Bahujan Party,4980,17,4997,S1321
2693,DARSHANA AMOL MEDHE,Prabuddha Republican Party,4730,6,4736,S1321
2694,KANOJE PRAKASH GIRDHARI,Independent,3917,3,3920,S1321
2695,VAMAN MAHADEV SANGALE,Dharmarajya Paksha,3861,0,3861,S1321
2696,SUDHIR SHRIDHAR DESHMUKH,Independent,3162,5,3167,S1321
2697,JITENDRA NARESH BHABHE (JITENDRA BHAVE),Independent,3125,7,3132,S1321
2698,ARIF USMAN MANSURI,Independent,2538,5,2543,S1321
2699,GANESH BALASAHEB BORASTE,Independent,2403,1,2404,S1321
2700,JAYSHRI MAHENDRA PATIL,Sainik Samaj Party,2398,28,2426,S1321
2701,SIDDHESHWARANAND SARASWATI,Independent,2378,10,2388,S1321
2702,SUSHAMA ABHIJIT GORANE,Independent,2258,2,2260,S1321
2703,KANTILAL KISAN JADHAV,Ambedkarite Party of India,2047,8,2055,S1321
2704,CHANDRABHAN AABAJI PURKAR,Independent,1888,2,1890,S1321
2705,YASHWANT VALU PARDHI,Bhartiya Asmita Party,1867,7,1874,S1321
2706,KAILASH MARUTI CHAVAN,Aam Janta Party (India),1686,17,1703,S1321
2707,KAMLAKAR BALASAHEB GAIKWAD,Dalit Soshit Pichhara Varg  Adhikar Dal,1639,7,1646,S1321
2708,DHANAJI ASHOK TOPALE,Independent,1376,0,1376,S1321
2709,BHAGYASHRI NITIN ADSUL,Indian Peoples Adhikar Party,1242,2,1244,S1321
2710,SOPAN NIVRUTTI SOMWANSHI,Independent,1210,1,1211,S1321
2711,ADV. ZUNJAR MHASUJI AVHAD,Bahujan Republican  Socialist Party,1205,5,1210,S1321
2712,KOLAPPA HANUMANT DHOTRE,Independent,1198,2,1200,S1321
2713,TILOTTAMA SUNIL JAGTAP,Independent,654,2,656,S1321
2714,DEEPAK GAIKWAD,Independent,640,2,642,S1321
2715,SACHINRAJE DATTATREYA DEORE,Independent,549,2,551,S1321
2716,DEVIDAS PIRAJI SARKATE,Independent,392,2,394,S1321
2717,NOTA,None of the Above,6144,41,6185,S1321
2718,IQRA CHOUDHARY,Samajwadi Party,526887,1126,528013,S242
2719,PRADEEP KUMAR,Bharatiya Janata Party,456075,2822,458897,S242
2720,SRIPAL,Bahujan Samaj Party,75978,222,76200,S242
2721,JAHID,Social Democratic Party Of India,3316,4,3320,S242
2722,SHOKINDER KUMAR,Independent,1983,2,1985,S242
2723,MANOJ RANA,Independent,1925,11,1936,S242
2724,VIKAS KUMAR,Independent,1098,2,1100,S242
2725,OMBEER,Azad Adhikar Sena,1088,8,1096,S242
2726,VIKRAM SINGH,Independent,897,3,900,S242
2727,PRITI KASHYAP,Rashtriya Mazdoor Ekta Party,781,10,791,S242
2728,VIKRAM SAINI,Akhand Bharat Swatantra Party,776,4,780,S242
2729,YOGESH,Independent,664,6,670,S242
2730,MOHD KADIR,Independent,436,6,442,S242
2731,NAND KISHOOR,Aapki Apni Party (Peoples),420,7,427,S242
2732,NOTA,None of the Above,3213,36,3249,S242
2733,JYOTSNA CHARANDAS MAHANT,Indian National Congress,569098,1084,570182,S264
2734,SAROJ PANDEY,Bharatiya Janata Party,525733,1166,526899,S264
2735,SHYAM SINGH MARKAM,Gondvana Gantantra Party,48498,89,48587,S264
2736,NIRDOSH  KUMAR YADAV,Independent,11267,1,11268,S264
2737,DUJRAM BOUDDH,Bahujan Samaj Party,10689,50,10739,S264
2738,JAICHANDRA SONPAKAR,Independent,6181,1,6182,S264
2739,PALAN SINGH,Independent,5706,3,5709,S264
2740,KAMAL DEV,Bhartiya Shakti Chetna Party,4985,3,4988,S264
2741,DILIP MIRI,Independent,3897,5,3902,S264
2742,KAUSHALYA BAI PORTE,Independent,3630,2,3632,S264
2743,PRATAP BHANU,Independent,2500,4,2504,S264
2744,SANTOSH SHARMA,Independent,2475,2,2477,S264
2745,AMRIKA KARPE,Independent,2227,5,2232,S264
2746,RAJGURU KEWAL GOSWAMI,Independent,2202,0,2202,S264
2747,SHOBRAN SINGH SAIMA,Independent,2072,1,2073,S264
2748,KALYAN SINGH TANWAR,Independent,1960,4,1964,S264
2749,RAJESH PANDEY,Independent,1814,0,1814,S264
2750,SUSHIL KUMAR VISHWAKARMA,Bhartiya Janta Secular Party,1684,1,1685,S264
2751,PRASHANT DANIEL,Sarv Adi Dal,1369,23,1392,S264
2752,REKHA TIWARI,Chhattisgarh Vikas Ganga Rashtriya Party,1289,5,1294,S264
2753,PURUSHOTTAM MANIKPURI,Independent,1212,0,1212,S264
2754,PRIYANKA PATEL,Republican Party of India (A),1197,7,1204,S264
2755,MAHENDRA KUMAR SHRIWAS (MANJU),Independent,1187,0,1187,S264
2756,SHEKH RAUF,Independent,1168,0,1168,S264
2757,SHIVPUJAN SINGH,Independent,1036,0,1036,S264
2758,SHANTI BAI MARAVI,Independent,858,3,861,S264
2759,RAMESH DAS MAHANT,Independent,823,0,823,S264
2760,NOTA,None of the Above,6076,21,6097,S264
2761,KALI CHARAN MUNDA,Indian National Congress,503997,7650,511647,S2711
2762,ARJUN MUNDA,Bharatiya Janata Party,358076,3896,361972,S2711
2763,SAVITRI DEVI,Bahujan Samaj Party,12202,98,12300,S2711
2764,BASANT KUMAR LONGA,Independent,10735,20,10755,S2711
2765,ARPANA HANS,Jharkhand Party,8450,82,8532,S2711
2766,PASTAR SANJAY KUMAR TIRKEY,Independent,4944,19,4963,S2711
2767,BABITA KACHHAP,Bharat Adivasi Party,4507,87,4594,S2711
2768,NOTA,None of the Above,21814,105,21919,S2711
2769,NARENDRA MODI,Bharatiya Janata Party,611439,1531,612970,S2477
2770,AJAY RAI,Indian National Congress,459084,1373,460457,S2477
2771,ATHER JAMAL LARI,Bahujan Samaj Party,33646,120,33766,S2477
2772,KOLISETTY SHIVA KUMAR,Yuga Thulasi Party,5748,2,5750,S2477
2773,GAGAN PRAKASH YADAV,Apna Dal (Kamerawadi),3619,15,3634,S2477
2774,DINESH KUMAR YADAV,Independent,2912,5,2917,S2477
2775,SANJAY KUMAR TIWARI,Independent,2170,1,2171,S2477
2776,NOTA,None of the Above,8463,15,8478,S2477
2777,KULDEEP INDORA,Indian National Congress,719896,6596,726492,S201
2778,PRIYANKA BALAN MEGHWAL,Bharatiya Janata Party,632097,6242,638339,S201
2779,DEVKARAN NAYAK,Bahujan Samaj Party,16090,212,16302,S201
2780,RAJKUMAR,Independent,4350,25,4375,S201
2781,KULWANT KAUR,Indian Peoples Green Party,4338,24,4362,S201
2782,DAYA RAM,Independent,3285,434,3719,S201
2783,RAJENDER KUMAR,Bhartiya Jan Samman Party,2383,60,2443,S201
2784,KANA RAM,Independent,2248,18,2266,S201
2785,MAJOR SINGH,Jai Hind Congress Party,2075,26,2101,S201
2786,NOTA,None of the Above,12940,155,13095,S201
2787,BAJRANG MANOHAR SONWANE,Nationalist Congress Party – Sharadchandra Pawar,682532,1418,683950,S1339
2788,PANKAJA GOPINATHRAO MUNDE,Bharatiya Janata Party,675349,2048,677397,S1339
2789,ASHOK BHAGOJI THORAT,Bahujan Maha Party,54829,21,54850,S1339
2790,ASHOK SUKHDEV HINGE,Vanchit Bahujan  Aaghadi,50741,126,50867,S1339
2791,SHAIKH TOUSIF ABDUL SATTAR,Independent,9472,0,9472,S1339
2792,DR. SIDDHARTH RAJENDRA TAKANKAR,Bahujan Samaj Party,5092,19,5111,S1339
2793,SHAMSHER KHAN SAHEB KHAN PATHAN,Independent,4704,0,4704,S1339
2794,JAVED SIKANDAR MOMIN,Independent,2662,0,2662,S1339
2795,NAZEM KHAN JABBAR KHAN PATHAN,Independent,2586,0,2586,S1339
2796,GOKUL BAPURAO SAWASE,Independent,2576,1,2577,S1339
2797,GAFFARKHAN JABBARKHAN PATHAN,Independent,2561,2,2563,S1339
2798,DATTA SUDAM GAIKWAD,Independent,2130,0,2130,S1339
2799,SATISH PADMAKAR KAPSE,Independent,2098,1,2099,S1339
2800,KARUNA DHANANJAY MUNDE,Swarajya Shakti Sena,1594,5,1599,S1339
2801,DR. SHRIRAM VITTHALRAO KHALGE,Independent,1512,0,1512,S1339
2802,ADV. GANESH NAVNATHRAO KARANDE,Independent,1506,2,1508,S1339
2803,SHITAL SHIVAJI DHONDRE,Independent,1302,1,1303,S1339
2804,SHAIKH YASHED SHAIKH TAYYAB,Independent,1258,0,1258,S1339
2805,JAWED SALEEM SYED,Tipu Sultan Party,972,6,978,S1339
2806,PRAKASH BHAGWANRAO SOLANKE,Independent,885,1,886,S1339
2807,CHANDRAKANT KUMAR HAJARE,Maharashtra Vikas Aghadi,800,3,803,S1339
2808,SALAUDDIN KHAN PATHAN,Independent,724,0,724,S1339
2809,KASPATE GANESH VYANKATRAO,Independent,719,0,719,S1339
2810,MUBEEN ZUBERI ZAHEER UL AFAQUE,Independent,675,1,676,S1339
2811,WASIM SHAIKH SALIM SHAIKH,Independent,579,1,580,S1339
2812,SHAIKH EJAJ SHAIKH UMAR,Independent,550,0,550,S1339
2813,SHESHERAO CHOKHOBA VEER,Prabuddha Republican Party,537,0,537,S1339
2814,TATE MAHENDRA ASHOK,Ambedkarist Republican Party,531,2,533,S1339
2815,MUSTAFA MAINODDIN SHAIKH,Independent,531,0,531,S1339
2816,SULEMAN KHAIRODDIN MOHMMAD,Independent,522,0,522,S1339
2817,HIDAYAT SADEKH ALI SYED,Independent,448,0,448,S1339
2818,RAJENDRA ACHYUTRAO HOKE,Independent,427,0,427,S1339
2819,ADV. MANIK BANSI AADMANE,Bahujan Republican  Socialist Party,425,1,426,S1339
2820,VACHISHT UDDHAV KUTE,Independent,414,0,414,S1339
2821,ADV. SHARAD BAHINAJI KAMBLE,All India National Raksha Sena,393,3,396,S1339
2822,BHASKAR BANSIDHARRAO KHANDE,Independent,390,0,390,S1339
2823,RAHEMAN BAHODDIN SAYYED,Independent,384,0,384,S1339
2824,LAXMIBAI BAJIRAO MORE,Independent,382,0,382,S1339
2825,SYED MINHAJ ALI,Independent,310,0,310,S1339
2826,SALIM ALLABAKSHA SAYYAD,Independent,238,0,238,S1339
2827,SADEK IBRAHIM SHAIKH,Independent,206,0,206,S1339
2828,NOTA,None of the Above,2068,19,2087,S1339
2829,E.T.  MOHAMMED BASHEER,Indian Union Muslim League,640269,3737,644006,S116
2830,V. VASEEF,Communist Party of India  (Marxist),341510,2378,343888,S116
2831,DR. ABDUL SALAM,Bharatiya Janata Party,84529,832,85361,S116
2832,T. KRISHNAN,Bahujan Samaj Party,1392,25,1417,S116
2833,P.C. NARAYANAN,Bahujan Dravida Party,1304,5,1309,S116
2834,NASEEF ALI MULLAPPALLI,Independent,1154,14,1168,S116
2835,ABDULSALAM S/O MUHAMMED HAJI,Independent,771,12,783,S116
2836,THRISSUR NAZEER,Independent,459,25,484,S116
2837,NOTA,None of the Above,6650,116,6766,S116
2838,TOKHAN SAHU,Bharatiya Janata Party,723194,1743,724937,S265
2839,DEVENDRA YADAV,Indian National Congress,558942,1437,560379,S265
2840,ASHWANI RAJAK,Bahujan Samaj Party,13175,47,13222,S265
2841,ANAND URAWAN,Independent,5894,4,5898,S265
2842,ANILESH MISHRA (MAHARAJ),Independent,5374,2,5376,S265
2843,KULESH KUMAR SAHU,Independent,4439,4,4443,S265
2844,ASHAVANT SAHOO,Bhartiya Shakti Chetna Party,4345,9,4354,S265
2845,SHRIKANT MALHWAYR (KASER),Loktantra Congress Party,4197,4,4201,S265
2846,VIKRAMPRASAD JOGI,Independent,2862,0,2862,S265
2847,KESHAV PRASAD,Independent,2765,2,2767,S265
2848,SUDIEP SHRIVASTAVA,Hamar Raj Party,2310,2,2312,S265
2849,RUPRAM SAHU,Independent,2261,0,2261,S265
2850,KRISHNA NANDAN SINGH,Independent,2020,0,2020,S265
2851,ROSHAN KUMAR,Independent,1920,0,1920,S265
2852,DINESH PRATAP SINGH KHUSRO NIKHIL,Rashtriya Gondvana Party,1792,16,1808,S265
2853,RAMESHWAR SAHU,Independent,1761,0,1761,S265
2854,VIJAY KUMAR,Independent,1625,1,1626,S265
2855,YASHUTOSH LAHARE,Ambedkarite Party of India,1271,3,1274,S265
2856,GHANSHYAM URF SADHELAL BHARDWAJ,Independent,1251,0,1251,S265
2857,VEDMANI SINGH KSHATRIYA (THAKUR),Independent,1163,0,1163,S265
2858,SHEKHAR BANJARE,Independent,1160,0,1160,S265
2859,SIDDHRAM LAHARE,Rashtriya Jansabha Party,1149,1,1150,S265
2860,RAMPYARE RAI,Independent,1112,0,1112,S265
2861,NAND KISHORE RAJ,Gondvana Gantantra Party,1049,12,1061,S265
2862,BHUNESHWAR MARKO,Independent,967,3,970,S265
2863,RAJKUMAR SAHU,Independent,828,1,829,S265
2864,BHAGWAT PATRE,Prabuddha Republican Party,710,2,712,S265
2865,LAKSHMAN  PATHAK,Ekam Sanatan Bharat Dal,698,1,699,S265
2866,ADVOCATE SHAILENDRA BANJARE (SHAKTIPUTRA),Shakti Sena (Bharat Desh),690,0,690,S265
2867,RAJENDRA KUMAR TANDAN,Independent,654,2,656,S265
2868,SALIK RAM JOGI,Independent,575,1,576,S265
2869,BASANT BANSL,Independent,564,0,564,S265
2870,DEEPMALA CHOUHAN,Chhattisgarh Vikas Ganga Rashtriya Party,559,6,565,S265
2871,MAHESH KUMAR SONWANI,Independent,559,1,560,S265
2872,DEV PRASAD BRAIHA,Independent,511,0,511,S265
2873,SANJAY PRAKASH SAHU,Independent,435,1,436,S265
2874,PARAS RAM YADAV,Independent,414,1,415,S265
2875,NOTA,None of the Above,2842,7,2849,S265
2876,ADITYA YADAV,Samajwadi Party,501390,465,501855,S2423
2877,DURVIJAY SINGH SHAKYA,Bharatiya Janata Party,466323,541,466864,S2423
2878,MUSLIM KHAN,Bahujan Samaj Party,97686,65,97751,S2423
2879,SANDEEP KUMAR,Independent,3835,1,3836,S2423
2880,DINESH KUMAR,Independent,2672,2,2674,S2423
2881,LATA YADAV,Independent,2572,6,2578,S2423
2882,NILAM RANI PAL,Rashtriya Shoshit Samaj Party,2428,10,2438,S2423
2883,RAM PRATAP MAURYA,Independent,1542,1,1543,S2423
2884,ISRAT ALI,Independent,1512,1,1513,S2423
2885,SULEMAN,Swaraj Bhartiya Nyay Party,1240,0,1240,S2423
2886,HARIRAJ SINGH URF SIPU YADAV,Log Party,909,1,910,S2423
2887,NOTA,None of the Above,8553,9,8562,S2423
2888,RAJKUMAR CHAHAR,Bharatiya Janata Party,442862,2795,445657,S2419
2889,RAMNATH SINGH SIKARWAR,Indian National Congress,400572,1680,402252,S2419
2890,PT.  RAMNIWAS SHARMA,Bahujan Samaj Party,120143,396,120539,S2419
2891,DR RAMESHWAR SINGH,Independent,48301,305,48606,S2419
2892,KALLAN KUMBHKAR,Independent,3458,5,3463,S2419
2893,HOTAM SINGH NISHAD,Rashtriya Shoshit Samaj Party,1805,5,1810,S2419
2894,GIRRAJ SINGH DHAKREY,"Proutist Bloc, India",1556,8,1564,S2419
2895,SANGEETA TOMAR,Bharatiya Majdoor Janta Party,1417,16,1433,S2419
2896,VED PRAKASH,Rashtriya Jansanchar Dal,1031,7,1038,S2419
2897,NOTA,None of the Above,7764,29,7793,S2419
2898,VIJAY BAGHEL,Bharatiya Janata Party,954356,2141,956497,S267
2899,RAJENDRA SAHU,Indian National Congress,517277,994,518271,S267
2900,DILIP RAMTEKE,Bahujan Samaj Party,13290,43,13333,S267
2901,ANOOP KUMAR PANDEY,Independent,7765,1,7766,S267
2902,DR. ANJU KEME,Ekam Sanatan Bharat Dal,5237,4,5241,S267
2903,ALI HUSSAIN SIDDIQUI,Independent,5046,4,5050,S267
2904,ARUN JOSHI,Independent,4751,2,4753,S267
2905,DHRUV KUMAR SONI URF LANGUR SONI,Independent,3813,2,3815,S267
2906,KHILANAND JASPAL,Independent,3280,1,3281,S267
2907,SUKHADEV TANDON,Rashtriya Jansabha Party,2615,2,2617,S267
2908,ASHOK JAIN,Independent,1902,0,1902,S267
2909,BALDEV SAHU,Independent,1610,3,1613,S267
2910,PUSHPA MAIRISHA,Ambedkarite Party of India,1556,5,1561,S267
2911,HARICHAND THAKUR,Independent,1451,1,1452,S267
2912,SAVITA SHAILENDRA BANJARE,Shakti Sena (Bharat Desh),1393,3,1396,S267
2913,RAKESH SAHU,Nyaydharmsabha,1261,1,1262,S267
2914,SHITKARAN MAHILWAR,Aazad Samaj Party (Kanshi Ram),1181,2,1183,S267
2915,DR. HARISHCHANDRA SAHU,Independent,1116,0,1116,S267
2916,SHANKAR THAKUR,Gondvana Gantantra Party,1064,9,1073,S267
2917,YASHWANT SITARAM SAHU,Bhartiya Shakti Chetna Party,899,2,901,S267
2918,SHYAM SUNDER SAHU,Loktantra Congress Party,897,2,899,S267
2919,VIKAS SHARMA,Lokshahi Ekta Party,798,0,798,S267
2920,SANTOSH KUMAR MARKANDE,Independent,646,4,650,S267
2921,BHAGBALI SIVARE,Independent,388,1,389,S267
2922,BHANUPRATAP CHATURVEDI,Independent,351,0,351,S267
2923,NOTA,None of the Above,5596,21,5617,S267
2924,AJAY TAMTA,Bharatiya Janata Party,417535,11632,429167,S283
2925,PRADEEP TAMTA,Indian National Congress,191642,3428,195070,S283
2926,NARAYAN RAM,Bahujan Samaj Party,9840,235,10075,S283
2927,KIRAN ARYA,Uttarakhand Parivartan Party,5528,250,5778,S283
2928,ARJUN PRASAD,Independent,4591,116,4707,S283
2929,DR PRAMOD KUMAR,Peoples Party of India (Democratic),4401,56,4457,S283
2930,ER JYOTI PRAKASH TAMTA,Bahujan Mukti Party,2178,46,2224,S283
2931,NOTA,None of the Above,16697,322,17019,S283
2932,NARESH CHANDRA UTTAM PATEL,Samajwadi Party,499866,462,500328,S2449
2933,NIRANJAN JYOTI,Bharatiya Janata Party,466249,880,467129,S2449
2934,MANISH SINGH SACHAN,Bahujan Samaj Party,90897,73,90970,S2449
2935,BIRENDRA SINGH,Independent,7917,3,7920,S2449
2936,KAMLESH KUMAR SINGH,Parivartan Samaj Party,5212,7,5219,S2449
2937,PANKAJ AWASTHI,Independent,4456,1,4457,S2449
2938,RAMKISHOR,Rashtra Uday Party,4075,4,4079,S2449
2939,JITENDRA KUMAR MAURYA,Independent,3333,3,3336,S2449
2940,KULDEEP KUSHWAHA,Independent,2724,2,2726,S2449
2941,RAJ BAHADUR,Peoples Party of India (Democratic),2653,1,2654,S2449
2942,NIRAJ KUMAR,Akhil Bhartiya Parivar Party,2561,6,2567,S2449
2943,RAM BIHARI,Bhartiya Shakti Chetna Party,2342,2,2344,S2449
2944,NEERAJ LODHI,Vikas Insaf Party,2028,5,2033,S2449
2945,JAY CHANDRA KUMAR,Vishwa Kalyan Rashtriya Manav Samaj Party,1602,2,1604,S2449
2946,RAJESH KUMAR PATEL,Sardar Patel Siddhant Party,1449,9,1458,S2449
2947,NOTA,None of the Above,8108,12,8120,S2449
2948,PARSHOTTAMBHAI RUPALA,Bharatiya Janata Party,850846,7138,857984,S0610
2949,DHANANI PARESH,Indian National Congress,368964,4760,373724,S0610
2950,CHAMANBHAI NAGJIBHAI SAVSANI,Bahujan Samaj Party,10356,109,10465,S0610
2951,AJAGIYA NIRALBHAI AMRUTLAL,Independent,3674,6,3680,S0610
2952,BHAVESHBHAI KANTILAL PIPALIYA,Independent,2846,10,2856,S0610
2953,BHAVESH UPENDRABHAI ACHARYA,Independent,2806,34,2840,S0610
2954,PRAKASH GOVINDBHAI SINDHAV,Independent,2355,34,2389,S0610
2955,ZALA NAYAN J.,Independent,2321,29,2350,S0610
2956,JIGNESHBHAI MAHAJAN,Independent,1322,10,1332,S0610
2957,NOTA,None of the Above,15288,634,15922,S0610
2958,PARIMAL SUKLABAIDYA,Bharatiya Janata Party,647572,4833,652405,S038
2959,SURYA KANTA SARKAR,Indian National Congress,386453,1641,388094,S038
2960,RADHESHYAM BISWAS,All India Trinamool Congress,20384,109,20493,S038
2961,RAJU DAS,Independent,4580,17,4597,S038
2962,PROBASH CHANDRA SARKAR,Socialist Unity Centre Of India (COMMUNIST),4494,40,4534,S038
2963,ANANTA MOHAN ROY,Independent,3113,30,3143,S038
2964,RAJIB DAS,Bahujan Maha Party,1843,24,1867,S038
2965,BARINDRA KUMAR DAS,Bangali Nabanirman Sena,1575,18,1593,S038
2966,NOTA,None of the Above,12598,102,12700,S038
2967,DR. VINOD KUMAR BIND,Bharatiya Janata Party,458877,1105,459982,S2478
2968,LALITESHPATI TRIPATHI,All India Trinamool Congress,414131,1779,415910,S2478
2969,HARISHANKAR,Bahujan Samaj Party,154718,335,155053,S2478
2970,PREMCHAND BIND,Pragatisheel Manav Samaj Party,13655,34,13689,S2478
2971,RAJ NARAYAN PATEL,Sardar Patel Siddhant Party,6198,8,6206,S2478
2972,RAM PRAKASH MISHRA,Rashtriya Samaj Paksha,5266,4,5270,S2478
2973,SUSHIL,All India Forward Bloc,5254,7,5261,S2478
2974,DR. SHYAMDHAR TIWARI,Independent,4842,6,4848,S2478
2975,KRISHNA DEV,Rashtra Uday Party,4590,7,4597,S2478
2976,DHIRENDRA KUMAR TIWARI,Independent,2944,4,2948,S2478
2977,NOTA,None of the Above,11222,7,11229,S2478
2978,BAG MITALI,All India Trinamool Congress,710432,2155,712587,S2529
2979,ARUP KANTI DIGAR,Bharatiya Janata Party,704124,2064,706188,S2529
2980,BIPLAB KUMAR MOITRA,Communist Party of India  (Marxist),92073,429,92502,S2529
2981,RAGHU MALLIK,Independent,16123,7,16130,S2529
2982,SUBIR KUMAR ROY,Bahujan Samaj Party,3807,24,3831,S2529
2983,VASKAR MALIK,Independent,3662,3,3665,S2529
2984,SUKANTA POREL,Socialist Unity Centre Of India (COMMUNIST),1807,9,1816,S2529
2985,BABLU GHANTI,Independent,1610,19,1629,S2529
2986,ABHIJIT MAJI,Independent,1600,6,1606,S2529
2987,ALOK DOLAI,Independent,1081,13,1094,S2529
2988,NOTA,None of the Above,17981,50,18031,S2529
2989,KAMLESH PASWAN,Bharatiya Janata Party,427528,1165,428693,S2467
2990,SADAL PRASAD,Indian National Congress,423872,1671,425543,S2467
2991,RAMSAMUJH,Bahujan Samaj Party,64567,183,64750,S2467
2992,GAYA PRASAD,Independent,6629,9,6638,S2467
2993,SHRVAN KUMAR NIRALA,Independent,4139,3,4142,S2467
2994,HEERALAL,Independent,2597,0,2597,S2467
2995,MURLI DHAR,Independent,1741,4,1745,S2467
2996,RAJENDRA CHAUDHARI,Independent,1629,5,1634,S2467
2997,NOTA,None of the Above,9006,15,9021,S2467
2998,KONDA VISHWESHWAR REDDY,Bharatiya Janata Party,798517,11365,809882,S2910
2999,DR GADDAM RANJITH REDDY,Indian National Congress,630861,6124,636985,S2910
3000,KASANI GYANESHWAR KASANI,Bharat Rashtra Samithi,177540,1428,178968,S2910
3001,RAMULU BINGI,Yuga Thulasi Party,4281,3,4284,S2910
3002,KONDA VISHVESHWAR REDDY,All India Forward Bloc,3736,12,3748,S2910
3003,SRIDEVI M,Alliance of Democratic Reforms Party,2684,4,2688,S2910
3004,MOHAMMED SALEEM,Rashtriya Praja Congress  (Secular),2372,1,2373,S2910
3005,SAHITHI DASARI,Independent,1924,14,1938,S2910
3006,RANJIT REDDY GADE,Revolutionary Socialist Party,1693,5,1698,S2910
3007,MOHD SHAKEEL,Desh Janhit Party,1646,1,1647,S2910
3008,THOTLA RAGHAVENDER MUDIRAJ,Dharma Samaj Party,1599,49,1648,S2910
3009,JANAPALA DURGA PRASAD,Independent,1516,1,1517,S2910
3010,JALEEL AHMED,Independent,1508,2,1510,S2910
3011,B V RAMESH NAIDU,Socialist Party (India),1494,1,1495,S2910
3012,PHANI PRASAD KATAKAM,Social Justice Party of India,1425,1,1426,S2910
3013,SUGURU SRINIVAS,Jai Swaraj Party,1385,1,1386,S2910
3014,G MALLESHAM GOUD,Independent,1239,1,1240,S2910
3015,KATHULA YADAIAH,Independent,1155,0,1155,S2910
3016,DURGA PRASAD T,Praja Velugu Party,1134,5,1139,S2910
3017,V PANDU,Independent,1070,5,1075,S2910
3018,SANEM RAJU GOUD,Praja Ektha Party,970,1,971,S2910
3019,GONE SRINIVAS REDDY,Independent,752,0,752,S2910
3020,GOVIND LAL,Independent,661,0,661,S2910
3021,MOHAMMED ABDUL QAVI ABBASI,All India Majlis-E-Inquilab-E-Millat,635,0,635,S2910
3022,MOHAMMAD PASHA,Independent,628,0,628,S2910
3023,P GOVIND,Bahujan Mukti Party,600,11,611,S2910
3024,EESARI SURYAPRAKASH REDDY,Independent,581,2,583,S2910
3025,SUDHAKAR VANAM,Marxist Communist Party of India (United),578,3,581,S2910
3026,NARASIMHA REDDY DYAPA,Telangana Republican Party,524,1,525,S2910
3027,MOHAMMED IQBAL,Independent,493,1,494,S2910
3028,VISHWAKARMA SAPTHAGIRI,Independent,489,0,489,S2910
3029,ANKAGALA PRAVEEN KUMAR,Independent,487,1,488,S2910
3030,ANJANEYULU NEERATI,Independent,446,3,449,S2910
3031,KANDIKEKAR SRINIVAS,Independent,445,1,446,S2910
3032,CHINTALAGARI VENKAT SWAMY,Blue India Party,431,5,436,S2910
3033,PALAMAKULA MADHU,India Praja Bandhu Party,428,2,430,S2910
3034,KAVALI SUKUMAR,Independent,392,5,397,S2910
3035,SERUBAI VASANTH KUMAR,Rashtra Samanya Praja Party,311,1,312,S2910
3036,MOHAMMED MUSTAFA RIZWAN,Independent,300,1,301,S2910
3037,MOHAMMAD RIAZUR REHMAN SHAIK,Independent,283,2,285,S2910
3038,MOHAMMED ALI,Independent,247,1,248,S2910
3039,AMIR SAJID,Independent,226,2,228,S2910
3040,MOHAMMED AFSAR QUDOOS,Independent,179,0,179,S2910
3041,NOTA,None of the Above,6313,110,6423,S2910
3042,MATHESWARAN V S,Dravida Munnetra Kazhagam,457695,4341,462036,S2216
3043,TAMILMANI S,All India Anna Dravida Munnetra Kazhagam,429358,3566,432924,S2216
3044,DR RAMALINGAM K P,Bharatiya Janata Party,103577,1113,104690,S2216
3045,KANIMOZHI G,Naam Tamilar Katchi,94895,682,95577,S2216
3046,DEEPAN CHAKKRAVARTHI S,Independent,3546,33,3579,S2216
3047,RAJENDRAN C,Viduthalai Kalam Katchi,2592,7,2599,S2216
3048,NATARAJAN M,Independent,2565,23,2588,S2216
3049,RAMESH T,Ahimsa Socialist Party,2412,9,2421,S2216
3050,EZHIL SELVAN P,Tamilaga Makkal Thannurimai Katchi,2149,16,2165,S2216
3051,RAMAN V,Bahujan Samaj Party,2137,20,2157,S2216
3052,UTHAYAKUMAR P,Independent,1899,2,1901,S2216
3053,KANDASAMY A M,Independent,1510,4,1514,S2216
3054,RAMASAMY P,Independent,1338,12,1350,S2216
3055,KARTHI S,Independent,1332,2,1334,S2216
3056,RAMESH T R,Independent,1317,8,1325,S2216
3057,SATHEESH G,Independent,1284,8,1292,S2216
3058,RAMASAMY N,Independent,1243,7,1250,S2216
3059,MADHESWARAN V,Independent,1144,3,1147,S2216
3060,DR GURUNATHAN S,Independent,1048,23,1071,S2216
3061,KARTHIKEYAN S,Independent,918,2,920,S2216
3062,NALLATHAMBI P,Independent,769,1,770,S2216
3063,EASWARAMOORTHY M,Independent,758,10,768,S2216
3064,BALAJICHEZHIAN P,Independent,716,3,719,S2216
3065,RAVIKUMAR P,Ganasangam Party of India,633,4,637,S2216
3066,NAVEEN K,Independent,633,2,635,S2216
3067,DURAIRAJ C,Independent,590,2,592,S2216
3068,ARULMANI M,Independent,564,4,568,S2216
3069,THIYAGARAJAN R,Samaniya Makkal Nala Katchi,527,1,528,S2216
3070,VENNILA S,Independent,520,8,528,S2216
3071,KALIANNAN S,Independent,496,1,497,S2216
3072,KANDASAMY P,Independent,475,5,480,S2216
3073,MANIKKAM S,Ulzaipali Makkal Katchy,439,3,442,S2216
3074,MOORTHI J,Independent,385,4,389,S2216
3075,TAMILMANI A,Independent,352,2,354,S2216
3076,SELVARAJ K R,Independent,301,2,303,S2216
3077,SAKTHIVEL S,Independent,298,1,299,S2216
3078,NETAJIKAVIARASU V,Independent,287,1,288,S2216
3079,SIVAKUMAR V,Independent,244,2,246,S2216
3080,MOORTHY V,Independent,220,2,222,S2216
3081,GOPAL P,Independent,214,0,214,S2216
3082,NOTA,None of the Above,12736,248,12984,S2216
3083,ABDUL RASHID SHEIKH,Independent,469574,2907,472481,U081
3084,OMAR ABDULLAH,Jammu & Kashmir National Conference,266301,2038,268339,U081
3085,SAJAD GANI LONE,Jammu & Kashmir People Conference,171582,1657,173239,U081
3086,MIR MOHAMMAD FAYAZ,Jammu & Kashmir Peoples Democratic Party,27173,315,27488,U081
3087,SURAIYA NISSAR,Independent,21565,53,21618,U081
3088,FIRDOUS AHMAD BHAT,Independent,15707,15,15722,U081
3089,SHAFEEQA BEGUM,Independent,6203,11,6214,U081
3090,PEERZADA MUDASIR RASHID SHAH,Jammu & Kashmir National Panthers Party (Bhim),5499,67,5566,U081
3091,KHURSHEED AHMAD SHAH,Rashtriya Jankranti Party,4213,55,4268,U081
3092,MOHAMMAD SULTAN GANAIE,Independent,4054,9,4063,U081
3093,SHADIB HANIEF KHAN,Independent,3668,2,3670,U081
3094,MUDASIR AHMAD TANTARY,Independent,3196,22,3218,U081
3095,NAZIR AHMAD SOFI,Independent,2980,3,2983,U081
3096,SHABIR AHMAD DAR,Independent,2694,6,2700,U081
3097,HILAL AHMAD WAGAY,Independent,2681,8,2689,U081
3098,MEHRAJ UDDIN NAJAR,Independent,2560,10,2570,U081
3099,SYED AMEER SUHAIL,Independent,2409,8,2417,U081
3100,FAROOQ AHMAD BHAT,National Youth Party,2315,28,2343,U081
3101,ARUN KUMAR RAINA,Independent,2161,80,2241,U081
3102,MUNIR AHMAD KHAN,Jammu and Kashmir Nationalist People's Front,2004,15,2019,U081
3103,MUZAFFAR HUSSAIN DAR,Independent,1663,8,1671,U081
3104,MUSHTAQ AHMAD MIR,National Loktantrik Party,1382,15,1397,U081
3105,NOTA,None of the Above,4873,111,4984,U081
3106,NARAYAN DAS AHIRWAR,Samajwadi Party,529444,736,530180,S2445
3107,BHANU PRATAP SINGH VERMA,Bharatiya Janata Party,475232,1050,476282,S2445
3108,SURESH CHANDRA GAUTAM,Bahujan Samaj Party,100105,143,100248,S2445
3109,BRIJ MOHAN,Independent,4666,7,4673,S2445
3110,NAGENDRA KUMAR,Bhartiya Shakti Chetna Party,3205,7,3212,S2445
3111,PREMLATA VERMA,Independent,3176,24,3200,S2445
3112,NOTA,None of the Above,11138,16,11154,S2445
3113,BHOJRAJ NAG,Bharatiya Janata Party,595185,2439,597624,S2611
3114,BIRESH THAKUR,Indian National Congress,593268,2472,595740,S2611
3115,TILAK RAM MARKAM,Bahujan Samaj Party,11694,76,11770,S2611
3116,SONSINGH,Ambedkarite Party of India,11351,11,11362,S2611
3117,JIVAN LAL MATLAM,Sarv Adi Dal,8935,14,8949,S2611
3118,SUKCHAND NETAM,Gondvana Gantantra Party,8617,106,8723,S2611
3119,VINOD NAGWANSHI,Hamar Raj Party,4958,51,5009,S2611
3120,THAKESH MAHLA,Bhartiya Shakti Chetna Party,4201,21,4222,S2611
3121,BHOJRAM MANDAVI,Rashtriya Jansabha Party,3326,35,3361,S2611
3122,NOTA,None of the Above,18618,51,18669,S2611
3123,KARTI P CHIDAMBARAM,Indian National Congress,425631,2046,427677,S2231
3124,XAVIERDASS A,All India Anna Dravida Munnetra Kazhagam,221255,758,222013,S2231
3125,DHEVANATHAN YADAV T,Bharatiya Janata Party,194559,1229,195788,S2231
3126,EZHILARASI,Naam Tamilar Katchi,162558,854,163412,S2231
3127,DHANALAKSHMI M,Independent,8494,18,8512,S2231
3128,GOVINDHARAJU M.G,Independent,4231,10,4241,S2231
3129,NAGARAJAN  KR,Independent,3682,14,3696,S2231
3130,PALANIYAPPAN  R,Independent,3426,1,3427,S2231
3131,RANJITHKUMAR BALUSWAMY,Bahujan Samaj Party,3160,11,3171,S2231
3132,BASKARAN S,Independent,2191,3,2194,S2231
3133,KALAISELVAM K,Independent,1660,3,1663,S2231
3134,MALAISAMY K,Independent,1524,3,1527,S2231
3135,SEKAR  A,Independent,1285,7,1292,S2231
3136,SELVARAJ P,Independent,1108,3,1111,S2231
3137,THILLAIVASAGAM   M,Vidiyalai Thedum Indhiyargal Party,1068,5,1073,S2231
3138,ASHOK KUMAR K,Independent,1030,4,1034,S2231
3139,KARTHICK  C,Independent,975,6,981,S2231
3140,MUTHARASU PANDIYAN  V,Independent,824,4,828,S2231
3141,KALAIRAJA  B,Independent,816,3,819,S2231
3142,KARTHIKAIRAJAN  P,Independent,762,9,771,S2231
3143,NOTA,None of the Above,8119,70,8189,S2231
3144,KRITI DEVI DEBBARMAN,Bharatiya Janata Party,768129,9318,777447,S232
3145,RAJENDRA REANG,Communist Party of India  (Marxist),287772,2856,290628,S232
3146,ARCHANA URANG,Independent,10814,108,10922,S232
3147,DARSHAN KUMAR REANG,Independent,9200,69,9269,S232
3148,SANTOJOY TRIPURA,Independent,6825,37,6862,S232
3149,SHIB CHANDRA DEBBARMA,Independent,6685,34,6719,S232
3150,SATRUGHNA JAMATIA,Independent,5939,28,5967,S232
3151,KRISHNA MOHAN JAMATIA,Independent,4166,51,4217,S232
3152,KALPA MOHAN TRIPURA,Independent,3958,53,4011,S232
3153,NOTA,None of the Above,18176,127,18303,S232
3154,HASMUKHBHAI PATEL (H.S.PATEL),Bharatiya Janata Party,763028,7431,770459,S067
3155,HIMMATSINH PRAHLADSINH PATEL,Indian National Congress,303713,4991,308704,S067
3156,MAKWANA JAYANTIBHAI KANJIBHAI,Bahujan Samaj Party,10235,247,10482,S067
3157,BRIJESH SHARMA,Independent,4514,12,4526,S067
3158,HARSHAD BABUBHAI NANDOLIYA,Independent,3554,17,3571,S067
3159,MAHESHKUMAR SOMABHAI THAKOR,Independent,3005,28,3033,S067
3160,KALPESHBHAI  SHETE,Gunj Satya Ni Janata Party,2927,10,2937,S067
3161,PATANI VISHNUBHAI NATAVARBHAI,Independent,2377,43,2420,S067
3162,ZALA SANJAYKUMAR MAHOBATSINH,Independent,2310,56,2366,S067
3163,DASHARATHBHAI KANTILAL PANCHAL,Independent,1474,6,1480,S067
3164,PRAMOD SAHDEVBHAI GUDADE,Swatantrata Abhivyakti Party,1275,4,1279,S067
3165,RAJESH HARIRAM MAURYA,Prajatantra Aadhar Party,1199,13,1212,S067
3166,INGOLE ROOPESHBHAI BABUBHAI,Independent,1153,16,1169,S067
3167,DHANANJAY GIRJASHANKAR RAJPUT,Bhartiya Jan Parishad,1083,37,1120,S067
3168,MANISH KUMAR DUBEY,Swaraj Kranti Party,898,11,909,S067
3169,CHAUHAN MOHAMADFARUK  AHEMADHASANBHAI,Independent,771,7,778,S067
3170,HITENDRABHAI PATEL,Aadi Bharat Party,722,20,742,S067
3171,PIYUSHBHAI BHAVSAR,Youth India Peace Party,642,7,649,S067
3172,NOTA,None of the Above,9911,592,10503,S067
3173,SHASHANK MANI,Bharatiya Janata Party,503509,1032,504541,S2466
3174,AKHILESH PRATAP SINGH,Indian National Congress,467946,1753,469699,S2466
3175,SANDESH,Bahujan Samaj Party,45446,118,45564,S2466
3176,SATENDER KUMAR MALL,Independent,4149,9,4158,S2466
3177,MUKTINATH SINGH,Janta Samta Party,3261,3,3264,S2466
3178,AGAMSWAROOP,Rashtriya Samanta Dal,3180,2,3182,S2466
3179,RAFIK ANSARI,Independent,2687,1,2688,S2466
3180,NOTA,None of the Above,10203,9,10212,S2466
3181,RAMVIR SINGH BIDHURI,Bharatiya Janata Party,691184,1648,692832,U057
3182,SAHI RAM,Aam Aadmi Party,567716,783,568499,U057
3183,ABDUL BASIT,Bahujan Samaj Party,9829,32,9861,U057
3184,RAM GOPAL,Haryana Jansena Party,3956,2,3958,U057
3185,CHANDRASHEKHAR SINGH KUSHWAHA,Independent,1888,1,1889,U057
3186,DEEPAK KAPILA,Independent,1500,0,1500,U057
3187,OMAPRAKASH,Samaj Vikas Kranti Party,1364,1,1365,U057
3188,JAGDISH KUMAR VERMA,Independent,1295,1,1296,U057
3189,LAKHAN SINGH,Navarang Congress Party,967,3,970,U057
3190,POONAM SRIVASTAVA,Independent,951,7,958,U057
3191,ARUN KUMAR,Independent,842,0,842,U057
3192,RINKI SANYAL,Bharatiya Sampuran Krantikari Party,762,1,763,U057
3193,KAMLESH KUMAR JHA,Independent,714,0,714,U057
3194,SURJEET SINGH,Delhi Janta Party,637,1,638,U057
3195,BHIM SINGH,Ambedkarite Party of India,601,1,602,U057
3196,SURINDER KUMAR,Bharatheeya Jawan Kisan Party,592,0,592,U057
3197,GAUTAM ANAND,All India Forward Bloc,539,1,540,U057
3198,SHANKAR DEY,Independent,522,0,522,U057
3199,BIHARI LAL JALANDHARI,India Greens Party,511,3,514,U057
3200,NAVEEN KUMAR,Hamara Sahi Vikalp Party,475,1,476,U057
3201,VIRENDER,Independent,381,0,381,U057
3202,RAJAN SINGH,Independent,323,2,325,U057
3203,NOTA,None of the Above,5927,34,5961,U057
3204,GURJEET SINGH AUJLA,Indian National Congress,254414,767,255181,S192
3205,KULDEEP SINGH DHALIWAL,Aam Aadmi Party,214268,612,214880,S192
3206,TARANJIT SINGH SANDHU SAMUNDRI,Bharatiya Janata Party,206832,373,207205,S192
3207,ANIL JOSHI,Shiromani Akali Dal,162686,210,162896,S192
3208,EMAAN SINGH MANN,Shiromani Akali Dal (Amritsar)(Simranjit Singh Mann),26584,212,26796,S192
3209,SATBIR SINGH  JAMMU,Independent,3394,5,3399,S192
3210,VISHAL SIDHU,Bahujan Samaj Party,2713,20,2733,S192
3211,DASWINDER KAUR,Communist Party of India,2468,13,2481,S192
3212,SHARANJIT KAUR,Independent,2456,4,2460,S192
3213,AMANPREET SINGH MAHADIPUR,Independent,2353,9,2362,S192
3214,GURINDER SINGH SABHI GILL,Independent,2124,5,2129,S192
3215,SAHIB SINGH,Independent,1987,1,1988,S192
3216,SHAMSHER SINGH SHERA,Independent,1504,3,1507,S192
3217,SHAM LAL GANDHI,Independent,1487,0,1487,S192
3218,LOVEPREET SHARMA,Aas Punjab Party,1372,3,1375,S192
3219,MASTER HARJINDER PAL,Independent,1358,0,1358,S192
3220,JASPAL MASIH,Independent,1223,4,1227,S192
3221,RESHAM SINGH,Independent,1130,3,1133,S192
3222,BAL KRISHAN SHARMA,Independent,1106,1,1107,S192
3223,SIMRANPREET SINGH,Independent,1104,2,1106,S192
3224,NARINDER KAUR,Aam Janta Party (India),1064,33,1097,S192
3225,DILDAR MASIH,Shiromani Lok Dal Party,1042,2,1044,S192
3226,RAJINDER KUMAR SHARMA,Independent,899,1,900,S192
3227,BALWINDER SINGH,Independent,854,3,857,S192
3228,GURPREET SINGH RATTAN,Republican Party of India (Athawale),735,3,738,S192
3229,DR RAMESH KUMAR,Sacho Sach Party,650,2,652,S192
3230,GAGANDEEP,Independent,608,2,610,S192
3231,PRITHVI PAL,Independent,434,0,434,S192
3232,NEELAM,Independent,404,5,409,S192
3233,DILBAGH SINGH,Independent,388,3,391,S192
3234,NOTA,None of the Above,3685,29,3714,S192
3235,MANI. A.,Dravida Munnetra Kazhagam,429301,3366,432667,S2210
3236,SOWMIYA ANBUMANI,Pattali Makkal Katchi,408445,2922,411367,S2210
3237,ASOKAN. R. DR.,All India Anna Dravida Munnetra Kazhagam,291590,2039,293629,S2210
3238,ABINAYA,Naam Tamilar Katchi,64576,805,65381,S2210
3239,THANGAVEL. K.,Dhesiya Makkal Kazhagam,7323,8,7331,S2210
3240,THIRUMURUGAN. P.,Independent,5668,3,5671,S2210
3241,HARI. R.,Bahujan Samaj Party,3128,38,3166,S2210
3242,SOWMIYA,Independent,3001,27,3028,S2210
3243,ELAYARANI. P.,Ganasangam Party of India,2301,14,2315,S2210
3244,ARUMUGAM. M.,Independent,2274,16,2290,S2210
3245,AGNI AALVAR,Independent,1643,8,1651,S2210
3246,PALANI. K.,Independent,1441,9,1450,S2210
3247,MANI. R.,Independent,1029,4,1033,S2210
3248,ASHOKAN. M.,Independent,1024,2,1026,S2210
3249,ALAGARASAN. R.,Independent,899,1,900,S2210
3250,SUNDHARAMOORTHY. M.,Independent,797,3,800,S2210
3251,MANI. C.,Independent,706,4,710,S2210
3252,PARTHASARATHI,Tamilar Makkal Katchi,698,11,709,S2210
3253,PADMARAJAN. K. DR.,Independent,649,8,657,S2210
3254,MANIVASAGAM. C.,Independent,648,3,651,S2210
3255,ASOKAN. G.,Independent,609,2,611,S2210
3256,AYYAKANNU,Independent,583,3,586,S2210
3257,JAGANATHAN. A.,Independent,551,2,553,S2210
3258,MANI. S.,Independent,451,1,452,S2210
3259,NOTA,None of the Above,9093,105,9198,S2210
3260,RACHNA BANERJEE,All India Trinamool Congress,700120,2624,702744,S2528
3261,LOCKET CHATTERJEE,Bharatiya Janata Party,623867,2024,625891,S2528
3262,MANADIP GHOSH,Communist Party of India  (Marxist),139250,669,139919,S2528
3263,SURAJIT HEMBRAM,Independent,9257,11,9268,S2528
3264,SAMIM ALI MOLLICK,Independent,6555,12,6567,S2528
3265,JAMINI BHAR,Bahujan Samaj Party,4684,34,4718,S2528
3266,AJANTA SARKAR,Bharatiya National Janata Dal,3619,20,3639,S2528
3267,SK KAMALUDDIN,Independent,2755,11,2766,S2528
3268,SANCHITA BERA,Independent,2632,17,2649,S2528
3269,PABAN MAZUMDER,Socialist Unity Centre Of India (COMMUNIST),2367,13,2380,S2528
3270,PRADIP PAL,Bharatiya Nyay-Adhikar Raksha Party,2205,15,2220,S2528
3271,MRINAL KANTI DAS,Independent,1387,11,1398,S2528
3272,NOTA,None of the Above,13250,102,13352,S2528
3273,DHAVAL LAXMANBHAI  PATEL,Bharatiya Janata Party,760935,3291,764226,S0626
3274,ANANTKUMAR HASMUKHBHAI PATEL,Indian National Congress,547307,6215,553522,S0626
3275,MANAKBHAI JATRUBHAI SHANKAR,Bahujan Samaj Party,7487,12,7499,S0626
3276,RAMANBHAI KARSHANBHAI PATEL,Independent,6732,13,6745,S0626
3277,JAYANTIBHAI KHANDUBHAI SHALUA,Viro Ke Vir Indian Party,4763,11,4774,S0626
3278,CHIRAGKUMAR BHARATBHAI  PATEL,Independent,3431,9,3440,S0626
3279,UMESHBHAI MAGANBHAI PATEL,Bahujan Republican  Socialist Party,2813,19,2832,S0626
3280,NOTA,None of the Above,18169,204,18373,S0626
3281,ANOOP PRADHAN BALMIKI,Bharatiya Janata Party,552334,2412,554746,S2416
3282,JASVEER VALMIKI,Samajwadi Party,306637,791,307428,S2416
3283,HEMBABOO DHANGAR,Bahujan Samaj Party,200876,387,201263,S2416
3284,JAYPAL MAHOR,Independent,3044,17,3061,S2416
3285,RAJPAL SINGH,Independent,2361,11,2372,S2416
3286,GHANSHYAM SINGH,Swaraj Bhartiya Nyay Party,2329,16,2345,S2416
3287,RAVI KUMAR,Independent,1638,7,1645,S2416
3288,DR. JAYVEER SINGH DHANGAR,Rashtra Uday Party,1591,16,1607,S2416
3289,DINESH SAI,Independent,1140,4,1144,S2416
3290,MUNNALAL JATAV,Independent,803,7,810,S2416
3291,NOTA,None of the Above,6257,42,6299,S2416
3292,DABHI  BHARATSINHJI  SHANKARJI,Bharatiya Janata Party,585591,6356,591947,S063
3293,CHANDANJI TALAJI THAKOR,Indian National Congress,555134,4937,560071,S063
3294,BALVANT CHHATRALIYA,Bahujan Samaj Party,5811,54,5865,S063
3295,SOYAB HASAM BHORANIYA,Independent,5473,1,5474,S063
3296,THAKOR KISHANBHAI KALUBHAI,Independent,2909,7,2916,S063
3297,SHARMA RAKESHBHAI,Rashtriya Samaj Paksha,2765,9,2774,S063
3298,GHAGHA MASIHULLAH ABDULHAMID,Social Democratic Party Of India,2305,7,2312,S063
3299,CHANDURA DHANJIBHAI LAXAMANBHAI,Independent,2135,25,2160,S063
3300,ABDULHAQ ISMAIL NEDARIYA,Independent,1510,14,1524,S063
3301,ABDULKUDDUS,Independent,1358,2,1360,S063
3302,NOTA,None of the Above,16382,340,16722,S063
3303,M. K. RAGHAVAN,Indian National Congress,515608,4813,520421,S115
3304,ELAMARAM KAREEM,Communist Party of India  (Marxist),369884,4361,374245,S115
3305,M. T. RAMESH,Bharatiya Janata Party,178692,1974,180666,S115
3306,ARAMUKHAN,Bahujan Samaj Party,1684,31,1715,S115
3307,ARAVINDAKSHAN NAIR M. K.,Bharatheeya Jawan Kisan Party,1290,15,1305,S115
3308,RAGHAVAN S/O NARAYANAN NAIR,Independent,1057,39,1096,S115
3309,T. RAGHAVAN S/O VELLANKUTTY,Independent,1009,9,1018,S115
3310,N. RAGHAVAN S/O DAMU,Independent,753,29,782,S115
3311,SUBHA,Independent,705,7,712,S115
3312,DR. M. JYOTHIRAJ,Socialist Unity Centre Of India (COMMUNIST),641,12,653,S115
3313,ABDUL KAREEM S/O MAHAMMOOD,Independent,536,5,541,S115
3314,ABDUL KAREEM S/O AYAMMATH KUTTY,Independent,285,2,287,S115
3315,ABDUL KAREEM K. S/O ASSAIN,Independent,257,36,293,S115
3316,NOTA,None of the Above,6236,80,6316,S115
3317,ANITA SUBHADARSHINI,Bharatiya Janata Party,493032,1194,494226,S1819
3318,RANJITA SAHU,Biju Janata Dal,393759,493,394252,S1819
3319,DEBAKANTA SARMA,Indian National Congress,75108,147,75255,S1819
3320,SANJAYA KUMAR BISHOYI,Independent,11234,6,11240,S1819
3321,PAPUNU SAHU,Socialist Unity Centre Of India (COMMUNIST),8671,2,8673,S1819
3322,PITABAS SAHU,Sanatan Sanskriti Raksha Dal,6888,0,6888,S1819
3323,BRUNDABANA NAHAK,Bahujan Samaj Party,5430,9,5439,S1819
3324,NOTA,None of the Above,21925,16,21941,S1819
3325,BHUPATHI RAJU SRINIVASA VARMA (B.J.P.VARMA),Bharatiya Janata Party,699382,7961,707343,S019
3326,UMABALA GUDURI,Yuvajana Sramika Rythu Congress Party,426037,4504,430541,S019
3327,K.B.R.NAIDU,Indian National Congress,34298,915,35213,S019
3328,PRASANNA KUMAR UNDURTHI,Independent,6350,14,6364,S019
3329,MEDAPATI VENKATA VARAHALA REDDY,Independent,5966,3,5969,S019
3330,SIRRA RAJU,Bahujan Samaj Party,5945,69,6014,S019
3331,BALAGAM NAYAKAR,Independent,5232,8,5240,S019
3332,NALLI RAJESH,Independent,4684,0,4684,S019
3333,KETHA SREENU,Independent,3140,5,3145,S019
3334,OLETY NAGENDRA KRISHNA,Jaibhim Rao Bharat Party,3112,4,3116,S019
3335,ADDEPALLI VEERA VENKAT SUBBA RAO,Independent,2781,2,2783,S019
3336,ANAND CHANDULAL JASTI,Independent,2726,0,2726,S019
3337,GANJI PURNIMA,Republican Party of India (A),1645,4,1649,S019
3338,GEDALA LAXMANA RAO,Independent,1525,2,1527,S019
3339,ADDANKI DORABABU,Independent,1388,5,1393,S019
3340,GOTTUMUKKALA SHIVAJI,Independent,1378,6,1384,S019
3341,ADINARAYANA DUPPANAPUDI,Independent,1002,5,1007,S019
3342,MANNE LEELA RAMA NARENDRA,Pyramid Party of India,922,8,930,S019
3343,RAMA DURGA PRASAD THOLETI,Independent,919,1,920,S019
3344,RUKHMINI,Independent,683,3,686,S019
3345,ADABALA SIVA,Independent,682,1,683,S019
3346,NOTA,None of the Above,7554,123,7677,S019
3347,JITENDRA KUMAR DOHARE,Samajwadi Party,489358,1389,490747,S2441
3348,DR RAM SHANKAR KATHERIA,Bharatiya Janata Party,430922,1406,432328,S2441
3349,SARIKA SINGH BAGHEL,Bahujan Samaj Party,96253,288,96541,S2441
3350,SUNIL SHANKWAR ADVOCATE,Independent,2954,9,2963,S2441
3351,MULAYAM SINGH,Independent,1688,20,1708,S2441
3352,BHUVNESH KUMARI,Samyak Party,1648,9,1657,S2441
3353,VIVEK RAJ,Janta Samajwadi Party (Vivek Raj),1569,5,1574,S2441
3354,NOTA,None of the Above,6229,37,6266,S2441
3355,KRISHNA DEVI SHIVSHANKER PATEL,Samajwadi Party,406018,549,406567,S2448
3356,R. K. SINGH PATEL,Bharatiya Janata Party,334950,407,335357,S2448
3357,MAYANK DWIVEDI,Bahujan Samaj Party,245530,215,245745,S2448
3358,RAMCHANDRA SARAS,Communist Party of India,9436,2,9438,S2448
3359,PANCHA URF PANCHAMLAL,Bhagidari Party(P),7714,3,7717,S2448
3360,GULAB CHANDER BARMA,Rashtra Uday Party,5905,2,5907,S2448
3361,RAMCHRAN,Independent,5419,4,5423,S2448
3362,SURENDRA KUMAR,Swatantra Jantaraj Party,4380,2,4382,S2448
3363,SHRIRAM SINGH GAUR,Bhartiya Shakti Chetna Party,3347,3,3350,S2448
3364,DINESH KUMAR PATEL,Sardar Patel Siddhant Party,2507,1,2508,S2448
3365,BABULAL,Log Party,2358,3,2361,S2448
3366,PRAMOD AZAD,Apna Dal (Kamerawadi),2141,1,2142,S2448
3367,NOTA,None of the Above,13226,9,13235,S2448
3368,VIJAY KUMAR DUBAY,Bharatiya Janata Party,516006,339,516345,S2465
3369,AJAY PRATAP SINGH URF PINTU SAITHWAR,Samajwadi Party,434210,345,434555,S2465
3370,SUBH NARAYAN CHAUHAN,Bahujan Samaj Party,67155,53,67208,S2465
3371,SWAMI PRASAD MAURYA,Rashtriya Shoshit Samaj Party,36559,16,36575,S2465
3372,HARIKESH,Azad Adhikar Sena,4094,3,4097,S2465
3373,RAMCHANDRA SINGH,Independent,3619,2,3621,S2465
3374,SUNIL KUMAR SHUKLA,Bhartiya Lok Nayak Party,3529,3,3532,S2465
3375,AMIY UPADHYAY,Independent,2432,1,2433,S2465
3376,VEDPRAKASH MISHRA,Subhashwadi Bhartiya Samajwadi Party (Subhas Party),2332,3,2335,S2465
3377,NOTA,None of the Above,9774,8,9782,S2465
3378,BACHHAV SHOBHA DINESH,Indian National Congress,582492,1374,583866,S132
3379,BHAMRE SUBHASH RAMRAO,Bharatiya Janata Party,577778,2257,580035,S132
3380,BHARAT BABURAO JADHAV,Independent,19695,18,19713,S132
3381,ZAHOOR AHAMAD MOHAMAD YUSUF (JAM JAM),Bahujan Samaj Party,4955,18,4973,S132
3382,SANJAY RAMESHWAR SHARMA,Independent,3741,5,3746,S132
3383,SHAFEEQUE AHEMAD MD. RAFEEQUE,Independent,3706,1,3707,S132
3384,NAMDEO ROHIDAS YELAVE,Bharatheeya Jawan Kisan Party,3659,24,3683,S132
3385,ADV SACHIN UMAJI NIKAM,Independent,3657,3,3660,S132
3386,RAJ CHAVAN,Independent,3443,9,3452,S132
3387,MOHAMMAD ISMAIL JUMMAN,Independent,1084,1,1085,S132
3388,SURESH JAGANNATH BRAHMANKAR (SURESH BAPU),Independent,1035,3,1038,S132
3389,PATIL SHIVAJI NATHU,All India Forward Bloc,994,7,1001,S132
3390,SHAIKH MOHAMMAD ZAID SHAMIM AHMED,Welfare Party Of India,946,5,951,S132
3391,MOHAMMAD AAMEEN MOHAMMAD FARUQUE,Independent,833,2,835,S132
3392,MUQEEM MEENA NAGRI,Bhim Sena,773,8,781,S132
3393,IRFAN. MO. ISHAK (NADIR),Independent,763,0,763,S132
3394,MALAY PRAKASH PATIL,Independent,734,2,736,S132
3395,ABDUL HAFEEZ ABDUL HAQUE,Independent,576,1,577,S132
3396,NOTA,None of the Above,4661,32,4693,S132
3397,SWAMI SACHCHIDANAND HARI SAKSHI,Bharatiya Janata Party,614832,1301,616133,S2433
3398,ANNU TANDON,Samajwadi Party,577699,2616,580315,S2433
3399,ASHOK KUMAR PANDEY,Bahujan Samaj Party,72245,282,72527,S2433
3400,SAIF KHAN,Parcham Party of India,8390,14,8404,S2433
3401,UMESH,Independent,5625,10,5635,S2433
3402,SHIV PRAKASH SINGH,Independent,4107,11,4118,S2433
3403,SAIYYAD SARFARAZ GANDHI,Independent,3018,5,3023,S2433
3404,HIMANSHU SHARMA,Bhartiya Shakti Chetna Party,2656,7,2663,S2433
3405,NOTA,None of the Above,9430,23,9453,S2433
3406,RAJ NATH SINGH,Bharatiya Janata Party,610597,2112,612709,S2435
3407,RAVIDAS MEHROTRA,Samajwadi Party,476303,1247,477550,S2435
3408,MOHAMMAD SARWAR MALIK,Bahujan Samaj Party,29982,210,30192,S2435
3409,MO AHMAD URF RINKU,Social Democratic Party Of India,3251,4,3255,S2435
3410,AKHAND PRATAP SINGH,Independent,1465,8,1473,S2435
3411,SARVAR ALI,Sarvar Party,1199,3,1202,S2435
3412,ISHTIYAQ ALI,Independent,929,5,934,S2435
3413,KAPIL MOHAN CHOWDHARY,Mera Adhikaar Rashtriya Dal,815,2,817,S2435
3414,GAURAV VERMA,Hindu Samaj Party,801,6,807,S2435
3415,BRIJESH KUMAR YADAV,Kisan Vishwa Party,601,2,603,S2435
3416,NOTA,None of the Above,7316,34,7350,S2435
3417,GAURAV GOGOI,Indian National Congress,743194,8577,751771,S0314
3418,TOPON KUMAR GOGOI,Bharatiya Janata Party,602019,5359,607378,S0314
3419,ARUN CHANDRA HANDIQUE,Ekam Sanatan Bharat Dal,8998,88,9086,S0314
3420,RAJ KUMAR DUWARA,Independent,8315,55,8370,S0314
3421,NOTA,None of the Above,14477,78,14555,S0314
3422,MOHIBBULLAH,Samajwadi Party,481252,251,481503,S247
3423,GHANSHYAM SINGH LODHI,Bharatiya Janata Party,393154,915,394069,S247
3424,ZEESHAN KHAN,Bahujan Samaj Party,79561,131,79692,S247
3425,ARSHAD WARSI,Minorities Democratic Party,2919,8,2927,S247
3426,MEHMOOD PRACHA,Independent,2750,9,2759,S247
3427,SHIV PRASAD,Independent,1465,11,1476,S247
3428,NOTA,None of the Above,5643,10,5653,S247
3429,DR. KALGE SHIVAJI BANDAPPA,Indian National Congress,607030,1991,609021,S1341
3430,SUDHAKAR TUKARAM SHRANGARE,Bharatiya Janata Party,545240,1900,547140,S1341
3431,NARSINGRAO UDGIRKAR,Vanchit Bahujan  Aaghadi,42104,121,42225,S1341
3432,ATITHI KHANDERAO SURYVANSHI,Swarajya Shakti Sena,5150,28,5178,S1341
3433,ALTE VISHWANATH MAHADEV,Bahujan Samaj Party,5081,40,5121,S1341
3434,KAMANT MACHHINDRA GUNWANTRAO,Bahujan Bharat Party,2249,20,2269,S1341
3435,ABHANG GANGARAM SURYAWANSHI,Independent,2102,0,2102,S1341
3436,DATTU SOPAN NARSINGE,Independent,2000,2,2002,S1341
3437,DEEPAK KEDAR,Independent,1712,14,1726,S1341
3438,UMESH AMBADAS KAMBLE,Independent,1683,8,1691,S1341
3439,BANSODE RAGHUNATH WAGHOJI,Independent,1596,4,1600,S1341
3440,BHARAT HARIBA NANAWARE,Peoples Party of India (Democratic),1442,7,1449,S1341
3441,SHRIKANT BABURAO HOVAL,Bahujan Mukti Party,1380,2,1382,S1341
3442,PRAVIN MADHAV JOHARE,Swarajya Sena (Maharashtra),1268,5,1273,S1341
3443,PANCHSHIL VIKRAM KAMBLE,Independent,1232,9,1241,S1341
3444,SHANKAR HARI TADAKHE,Baliraja Party,1126,2,1128,S1341
3445,AMOL MALU HANMANTE,Independent,1094,5,1099,S1341
3446,ADV. KASBEKAR SHRIDHAR LIMBAJI,Rashtriya Sant Sandesh Party,987,7,994,S1341
3447,BALAJI SHESHRAO BANSODE,Independent,953,1,954,S1341
3448,BHIKAJI GANGARAM JADHAV,Kranti Kari Jai Hind Sena,863,3,866,S1341
3449,VIKAS KONDIBA SHINDE,Maharashtra Vikas Aghadi,793,8,801,S1341
3450,LAKHAN RAJARAM KAMBLE,Rashtriy Bahujan Party,790,5,795,S1341
3451,BALAJI TUKARAM GAIKWAD,Bharat Peoples Sena,679,4,683,S1341
3452,SUDHAKAR TUKARAM SURYAWANSHI,Independent,617,3,620,S1341
3453,PAPITA RAOSAHEB RANDIVE,Independent,576,5,581,S1341
3454,ADV. PRADIP S. CHINCHOLIKAR,Independent,528,5,533,S1341
3455,MUKESH GOVINDRAO GHODAKE,Independent,524,1,525,S1341
3456,PANKAJ GOPALRAO WAKHARADAKAR,Independent,512,1,513,S1341
3457,NOTA,None of the Above,3542,25,3567,S1341
3458,JYOTIRADITYA M. SCINDIA,Bharatiya Janata Party,919744,3558,923302,S124
3459,YADVENDRA RAO DESHRAJ SINGH,Indian National Congress,380909,1464,382373,S124
3460,DHANIRAM CHAUDHARY,Bahujan Samaj Party,30105,130,30235,S124
3461,KANCHHEDI LAL KUSHWAHA,Mahanwadi Party,5850,6,5856,S124
3462,ADVOCATE KARANSINGH JATAV,Aazad Samaj Party (Kanshi Ram),5474,11,5485,S124
3463,HEMANT SINGH KUSHWAHA,Independent,3450,3,3453,S124
3464,RAKESH,Independent,3051,1,3052,S124
3465,MAHENDRA JAIN BHAIYAN,Independent,1990,9,1999,S124
3466,MOHAN,Independent,1883,3,1886,S124
3467,GAJANAND KUSHWAH,Independent,1595,2,1597,S124
3468,MANISH SHRIVASTAVA,Socialist Unity Centre Of India (COMMUNIST),1342,6,1348,S124
3469,MANMOHAN,Independent,1143,6,1149,S124
3470,KISAN LAL AHIRWAR,Independent,1033,11,1044,S124
3471,MOHAMMAD JAVED ANSARI,Rashtriya Jansena Party,983,0,983,S124
3472,D.S. CHAUHAN (ADVOCATE),Rashtriya Samaj Paksha,913,2,915,S124
3473,NOTA,None of the Above,9055,34,9089,S124
3474,KARTICK CHANDRA PAUL,Bharatiya Janata Party,558644,2253,560897,S255
3475,KALYANI KRISHNA,All India Trinamool Congress,491150,1550,492700,S255
3476,ALI IMRAN RAMZ,Indian National Congress,262694,579,263273,S255
3477,DWARIK NATH BARMAN,Independent,8258,6,8264,S255
3478,MD NAZIR AKHTAR,Independent,6004,1,6005,S255
3479,KALIDASH MURMU,Independent,5865,3,5868,S255
3480,SWAPAN KUMAR DAS,Bahujan Samaj Party,4106,11,4117,S255
3481,RUPAK ROY,Independent,3355,3,3358,S255
3482,FAKIRA MD,Independent,3353,2,3355,S255
3483,DURGA MURMU,Ambedkarite Party of India,3330,4,3334,S255
3484,PALASH CHANDRA MAHATO,Independent,3112,2,3114,S255
3485,ALI IMRAN,Independent,1939,7,1946,S255
3486,MD ABRAHIM HOQUE,Independent,1761,2,1763,S255
3487,SHAHIDUR RAHMAN,North Bengal People’s Party,1458,4,1462,S255
3488,SHARANYA DUTTA,Independent,1328,2,1330,S255
3489,SANATAN DUTTA,Socialist Unity Centre Of India (COMMUNIST),1256,15,1271,S255
3490,TAPAN BARMAN,Jai Prakash Janata Dal,1249,2,1251,S255
3491,ANWARUL HOQUE,Independent,1187,3,1190,S255
3492,RAMESH CHANDRA SINHA,Bhumiputra United Party,1046,5,1051,S255
3493,AL MONOWARA BEGAM,India Manus Party,977,5,982,S255
3494,NOTA,None of the Above,1924,16,1940,S255
3495,KINJARAPU RAMMOHAN NAIDU,Telugu Desam,734501,19827,754328,S012
3496,TILAK PERADA,Yuvajana Sramika Rythu Congress Party,420394,6033,426427,S012
3497,PEDADA PARAMESWARA RAO,Indian National Congress,6724,448,7172,S012
3498,SANAPALA SRAVAN KUMAR,Independent,5950,8,5958,S012
3499,NAIDUGARI RAJASEKHAR,Bahujan Samaj Party,4661,81,4742,S012
3500,VABA YOGESWARA RAO,Independent,3472,126,3598,S012
3501,BETHA VIVEKANANDA MAHARAJ,Independent,2523,13,2536,S012
3502,YEDDU LAKSHMINARAYANA,Independent,1598,7,1605,S012
3503,BORUBADRA CHANDRAKALA,Bharatha Chaitanya Yuvajana Party,1315,42,1357,S012
3504,IPPILI SEETHARAJU,Jai Bharat National Party,1080,50,1130,S012
3505,KAYA DURGARAO,Navarang Congress Party,811,7,818,S012
3506,CHELLURI DANIYAL,Independent,796,20,816,S012
3507,BOMMALI TIRUPATI RAO,Pyramid Party of India,589,5,594,S012
3508,NOTA,None of the Above,24498,107,24605,S012
3509,MALA ROY,All India Trinamool Congress,612725,2549,615274,S2523
3510,DEBASREE CHAUDHURI,Bharatiya Janata Party,426459,1584,428043,S2523
3511,SAIRA SHAH HALIM,Communist Party of India  (Marxist),167771,760,168531,S2523
3512,NIRAJ AGARWAL,Independent,4028,4,4032,S2523
3513,FIROZA KHATUN,Bahujan Samaj Party,3958,17,3975,S2523
3514,SANTANU ROY,Independent,2918,2,2920,S2523
3515,ZUBAIR RABBANI,Socialist Unity Centre Of India (COMMUNIST),2290,10,2300,S2523
3516,SUSANTA MONDAL,Independent,2090,1,2091,S2523
3517,MUMTAZ ALI,Independent,1960,9,1969,S2523
3518,MUKTI,Right to Recall Party,1537,7,1544,S2523
3519,SANJOY (RANA) CHANDA,Kisan Mazdoor Sangharsh Party,1186,7,1193,S2523
3520,SANJANA RAM,Independent,1052,4,1056,S2523
3521,YASMIN ISLAM,Social Democratic Party Of India,981,4,985,S2523
3522,ATANU DAS,Independent,969,2,971,S2523
3523,MRIDUL OJHA,Independent,856,6,862,S2523
3524,DIPENDU HAZRA,Independent,794,10,804,S2523
3525,MD. SHAKIL WARSI,Independent,503,1,504,S2523
3526,NOTA,None of the Above,6348,75,6423,S2523
3527,ANGOMCHA BIMOL AKOIJAM,Indian National Congress,370678,3339,374017,S141
3528,THOUNAOJAM BASANTA KUMAR SINGH,Bharatiya Janata Party,262217,1999,264216,S141
3529,MAHESHWAR THOUNAOJAM,Republican Party of India (Athawale),134308,1332,135640,S141
3530,RAJKUMAR SOMENDRO SINGH,Independent,12892,158,13050,S141
3531,MOIRANGTHEM TOTOMSHANA NONGSHABA,Independent,4831,50,4881,S141
3532,HAORUNGBAM SARAT SINGH,Independent,1279,17,1296,S141
3533,NOTA,None of the Above,3707,90,3797,S141
3534,SUKANTA KUMAR PANIGRAHI,Bharatiya Janata Party,413320,3095,416415,S1813
3535,ACHYUTANANDA SAMANTA,Biju Janata Dal,393644,1400,395044,S1813
3536,AMIR CHAND NAYAK,Indian National Congress,143311,1011,144322,S1813
3537,BHAGIRATHI BALIARSINGH,Manas Lokshakti Dal,7329,1,7330,S1813
3538,KANAK MANJARI RATH,Independent,5201,4,5205,S1813
3539,HARIBANDHU BEHERA,Bahujan Samaj Party,5121,16,5137,S1813
3540,SUBASH MOHAPATRA,National Jan Dal,4133,4,4137,S1813
3541,PARSURAM PRADHAN,Kalinga Sena,2770,11,2781,S1813
3542,NOTA,None of the Above,15691,29,15720,S1813
3543,MALA RAJYA LAKSHMI SHAH,Bharatiya Janata Party,455949,6654,462603,S281
3544,JOT SINGH GUNSOLA,Indian National Congress,187602,2508,190110,S281
3545,BOBY PANWAR,Independent,162469,5612,168081,S281
3546,NAVNEET SINGH GOSAIN,Rashtriya Uttarakhand Party,9969,57,10026,S281
3547,NEMCHAND,Bahujan Samaj Party,6786,122,6908,S281
3548,BRIJ BHUSHAN KARANWAL,Bhartiya Rashtriya Ekta Dal,3545,25,3570,S281
3549,SARDAR KHAN PAPPU,Independent,3268,7,3275,S281
3550,VEPIN KUMAR AGGARWAL,Independent,3173,43,3216,S281
3551,RAMPAL SINGH,Peoples Party of India (Democratic),2343,19,2362,S281
3552,SUDESH TOMAR,Independent,2261,7,2268,S281
3553,PREM DUTT SEMWAL,Independent,2134,30,2164,S281
3554,NOTA,None of the Above,7304,154,7458,S281
3555,DAGGUMALLA PRASADA RAO,Telugu Desam,765536,12535,778071,S0125
3556,REDDEPPA.N .,Yuvajana Sramika Rythu Congress Party,552469,5123,557592,S0125
3557,MOTUKUR JAGAPATHI,Indian National Congress,29431,719,30150,S0125
3558,THOGURU VIJAYA KUMAR,Bahujan Samaj Party,13389,122,13511,S0125
3559,YUGANDAR . KONDA,Independent,6889,84,6973,S0125
3560,K.MUNI KRISHNA,Independent,3954,2,3956,S0125
3561,P.JANAKI RAMA RAO ( BABU),National Maha Sabha Party,2822,11,2833,S0125
3562,PETA.MOHAN .,Independent,2365,1,2366,S0125
3563,C.SUDHAKAR,Independent,1934,1,1935,S0125
3564,N.CHANDRABABU,Independent,1878,7,1885,S0125
3565,MADASI SUDHARSHAN,Independent,1575,3,1578,S0125
3566,D.MAHESH,Independent,1109,10,1119,S0125
3567,P.MADHU,Independent,902,4,906,S0125
3568,N.BHUPATHI,Independent,862,32,894,S0125
3569,A. PURNA CHANDRA,Independent,856,1,857,S0125
3570,PALLIPATTU.ABHINAV VISHNU,Samajwadi Party,670,6,676,S0125
3571,N.GANGAIAH .,Independent,547,5,552,S0125
3572,T NARESH,Independent,532,2,534,S0125
3573,BANDAPALLI RAMESH,Independent,490,3,493,S0125
3574,NOTA,None of the Above,11812,164,11976,S0125
3575,RAVIKUMAR. D,Viduthalai Chiruthaigal Katchi,474230,2803,477033,S2213
3576,BHAGYARAJ. J,All India Anna Dravida Munnetra Kazhagam,404503,1827,406330,S2213
3577,MURALI SANKAR. S,Pattali Makkal Katchi,180020,1862,181882,S2213
3578,KALANCHIYAM. M,Naam Tamilar Katchi,56766,476,57242,S2213
3579,KARUNCHIRUTHAI KALIYAMURTHY. K,Bahujan Samaj Party,3883,37,3920,S2213
3580,ARUMUGAM. M,United Republican Party of India,3487,17,3504,S2213
3581,DHARMA. K,Independent,2375,7,2382,S2213
3582,VIVEKANANDHAN. E,Independent,1945,8,1953,S2213
3583,ARASAN. K,Independent,1835,7,1842,S2213
3584,VIGNESVARAN. R,Independent,1643,13,1656,S2213
3585,SURESH. S,Independent,1374,23,1397,S2213
3586,PERIYAN. A,Independent,1041,8,1049,S2213
3587,GUNASEKARAN. K,Independent,960,3,963,S2213
3588,VIJAYAN. A,Independent,859,2,861,S2213
3589,NAGARAJ. A,Independent,669,5,674,S2213
3590,SURESH. K,Independent,592,6,598,S2213
3591,SATHIYARAJ. N,Independent,412,3,415,S2213
3592,NOTA,None of the Above,8874,92,8966,S2213
3593,GOPAL JEE THAKUR,Bharatiya Janata Party,565706,924,566630,S0414
3594,LALIT KUMAR YADAV,Rashtriya Janata Dal,387408,1066,388474,S0414
3595,SAROJ CHAUDHARY,Mithilanchal Mukti Morcha,18018,7,18025,S0414
3596,DURGANANDA MAHAVIR NAYAK,Bahujan Samaj Party,8259,9,8268,S0414
3597,MITHILESH MAHTO,Independent,6983,9,6992,S0414
3598,KISHOR KUMAR DAS,Akhil Bhartiya Parivar Party,5716,5,5721,S0414
3599,RAJNISH KUMAR,Jantantra Awaj Party,3634,4,3638,S0414
3600,RANJEET KUMAR RAM,Wazib Adhikar Party,2529,3,2532,S0414
3601,NOTA,None of the Above,23881,23,23904,S0414
3602,MURARI LAL MEENA,Indian National Congress,636868,9398,646266,S2011
3603,KANHAIYA LAL MEENA,Bharatiya Janata Party,404309,4617,408926,S2011
3604,SONU DHANKA,Bahujan Samaj Party,6752,45,6797,S2011
3605,"DR. RAM ROOP MEENA, ADVOCATE",Independent,2701,20,2721,S2011
3606,MOHAN LAL MEENA,Independent,2164,14,2178,S2011
3607,NOTA,None of the Above,5789,57,5846,S2011
3608,MAHENDRA SINGH SOLANKY,Bharatiya Janata Party,925917,3024,928941,S1221
3609,RAJENDRA RADHAKISHAN MALVIYA,Indian National Congress,502548,1168,503716,S1221
3610,RAJENDRASINGH CHOKHUTIYA,Bahujan Samaj Party,11162,41,11203,S1221
3611,RAMPRASAD,Aazad Samaj Party (Kanshi Ram),7201,19,7220,S1221
3612,NITIN VERMA,Independent,2756,5,2761,S1221
3613,ADVOCATE VIDAYARAJ MALAVIY,Social Democratic Party Of India,2026,5,2031,S1221
3614,ENG. DEEPAK RAMESH CHANDRA VICHITRA,Independent,1585,10,1595,S1221
3615,HEMRAJ POONAMCHANDRA BAMNIYA,Public Political Party,1236,12,1248,S1221
3616,NOTA,None of the Above,10365,24,10389,S1221
3617,RANJIT DUTTA,Bharatiya Janata Party,771018,4770,775788,S0311
3618,PREMLAL GANJU,Indian National Congress,412553,1827,414380,S0311
3619,RISHIRAJ KAUNDINYA,Aam Aadmi Party,32771,277,33048,S0311
3620,RAJU DEURI,Bodoland Peoples Front,19775,117,19892,S0311
3621,PRADIP BHANDARI,Independent,8136,69,8205,S0311
3622,KAMESWAR SWARGIARY,Voters Party  International,7320,62,7382,S0311
3623,RINKU ROY,Gana Suraksha Party,6780,43,6823,S0311
3624,ALAM ALI,Bahujan Maha Party,4186,16,4202,S0311
3625,NOTA,None of the Above,18535,213,18748,S0311
3626,PRIYA SAROJ,Samajwadi Party,449561,1731,451292,S2474
3627,BHOLANATH (B.P. SAROJ),Bharatiya Janata Party,414494,948,415442,S2474
3628,KRIPA SHANKAR SAROJ,Bahujan Samaj Party,156930,361,157291,S2474
3629,SHRAVAN KUMAR,Independent,5804,3,5807,S2474
3630,URMILA,Samaj Parivartan Party,5296,7,5303,S2474
3631,SUBAS,Independent,3691,2,3693,S2474
3632,RANG BAHADUR,Independent,2715,3,2718,S2474
3633,BRIJESH KUMAR SAROJ,Prabuddhwadi Bahujan Morcha,2365,0,2365,S2474
3634,RAJENDRA PRASAD,Rashtra Uday Party,2066,1,2067,S2474
3635,RAM MILAN,Sardar Patel Siddhant Party,1713,3,1716,S2474
3636,KAMLESH,Azad Samaj Party,1698,4,1702,S2474
3637,BRIJESH KUMAR,Prithviraj Janshakti Party,1362,2,1364,S2474
3638,NOTA,None of the Above,9277,26,9303,S2474
3639,DR RAJKUMAR SANGWAN,Rashtriya Lok Dal,485765,3202,488967,S2411
3640,AMARPAL,Samajwadi Party,328487,1021,329508,S2411
3641,PRAVEEN BANSAL,Bahujan Samaj Party,91740,526,92266,S2411
3642,MUKESH KUMAR SHARMA,Azad Adhikar Sena,5441,82,5523,S2411
3643,MAHENDER SINGH,Sarvjan Samta Party,4957,63,5020,S2411
3644,SUKHVIR SINGH,Swatantra Jantaraj Party,4056,43,4099,S2411
3645,RUBY KASHYAP,Sarvjan Lok Shakti Party,3202,78,3280,S2411
3646,NOTA,None of the Above,4980,130,5110,S2411
3647,AFZAL ANSARI,Samajwadi Party,537784,2128,539912,S2475
3648,PARS NATH RAI,Bharatiya Janata Party,413518,1533,415051,S2475
3649,UMESH KUMAR SINGH,Bahujan Samaj Party,164601,363,164964,S2475
3650,AJAY,Vishwa Kalyan Rashtriya Manav Samaj Party,5068,6,5074,S2475
3651,NUSRAT ANSARI,Independent,4567,49,4616,S2475
3652,ADITYA SHRIVASTAV,Yuga Thulasi Party,3312,4,3316,S2475
3653,SATYDEV YADAV,Independent,3163,9,3172,S2475
3654,GYANCHANDRA BIND,Independent,3127,8,3135,S2475
3655,RAMPRAVESH,Moulik Adhikar Party,2830,3,2833,S2475
3656,DHANANJAY KUMAR TIWARI,Bhartiya Lokvani Party,1949,7,1956,S2475
3657,NOTA,None of the Above,9033,32,9065,S2475
3658,BAPI HALDAR,All India Trinamool Congress,752486,3245,755731,S2520
3659,ASHOK PURKAIT,Bharatiya Janata Party,552798,1876,554674,S2520
3660,AJAY KUMAR DAS,All India Secular Front,87530,76,87606,S2520
3661,DR SARAT CHANDRA HALDER,Communist Party of India  (Marxist),60778,322,61100,S2520
3662,BAPI HALDER,Independent,8922,12,8934,S2520
3663,BAPI HALDAR,Independent,5607,19,5626,S2520
3664,BISWANATH SARDAR,Socialist Unity Centre Of India (COMMUNIST),4505,29,4534,S2520
3665,PANKAJ KUMAR HALDER,Bahujan Samaj Party,4238,19,4257,S2520
3666,ASHOKE PUROKAIT,Independent,1489,12,1501,S2520
3667,ASHOKE SARDAR,Independent,1474,27,1501,S2520
3668,BAPPA DAS,Party for Democratic Socialism,1203,6,1209,S2520
3669,RUDRA PRASAD MANDAL,Mulnibasi Party of India,707,13,720,S2520
3670,NOTA,None of the Above,8593,38,8631,S2520
3671,JITAN RAM MANJHI,Hindustani Awam Morcha (Secular),492732,2228,494960,S0438
3672,KUMAR SARVJEET,Rashtriya Janata Dal,390469,2679,393148,S0438
3673,SUSHMA KUMARI,Bahujan Samaj Party,12234,142,12376,S0438
3674,DEVENDRA PRATAP,Independent,9209,2,9211,S0438
3675,DHEERENDRA PRASAD,Loktantrik Samajwadi Party,5616,13,5629,S0438
3676,GIRIDHAR SAPERA,The National Road Map Party of India,4708,19,4727,S0438
3677,RANU KUMAR CHAUDHARY,Independent,4495,10,4505,S0438
3678,RANJAN KUMAR,Independent,4233,1,4234,S0438
3679,AYUSH KUMAR,Independent,4098,5,4103,S0438
3680,SURENDRA MANJHI,Rashtriya Jansambhavna Party,3023,12,3035,S0438
3681,AMRESH KUMAR,Independent,2800,21,2821,S0438
3682,ASHOK KUMAR PASWAN,Independent,2692,9,2701,S0438
3683,ARUN KUMAR,Independent,2531,23,2554,S0438
3684,SHEO SHANKAR,Bhartiya Lok Chetna Party,2370,14,2384,S0438
3685,NOTA,None of the Above,17177,111,17288,S0438
3686,ARUNA. D. K,Bharatiya Janata Party,506747,4000,510747,S2911
3687,CHALLA VAMSHI CHAND REDDY,Indian National Congress,503111,3136,506247,S2911
3688,MANNE SRINIVAS REDDY,Bharat Rashtra Samithi,154296,496,154792,S2911
3689,VENKATESWARLU TALLADA,Alliance of Democratic Reforms Party,6375,4,6379,S2911
3690,KINNERA YADAGIRI,Independent,4470,0,4470,S2911
3691,KURA VENKATAIAH,Independent,4248,1,4249,S2911
3692,HARINDER REDDY MALLELA,Independent,3814,1,3815,S2911
3693,KARUKONDA SRINIVAS YADAV,Independent,3450,1,3451,S2911
3694,HANUMESH,Independent,3225,0,3225,S2911
3695,MOHD ALAUDDIN,Bahujan Samaj Party,3056,21,3077,S2911
3696,GOVINDAMMA,Independent,2748,0,2748,S2911
3697,GANTLAVELLI RAKESH,Dharma Samaj Party,2600,18,2618,S2911
3698,UMASHANKAR NEMMIKANTI,Independent,2214,0,2214,S2911
3699,DINESH,Independent,1726,1,1727,S2911
3700,ANDHARI ANJAIAH,Independent,1669,6,1675,S2911
3701,SANGEPAGA SAROJANAMMA,Independent,1563,2,1565,S2911
3702,B. RAVINDER,Social Justice Party of India,1082,3,1085,S2911
3703,K. UDAY TEJ NAIK,Independent,1027,0,1027,S2911
3704,MARLA ANJANEYULU,Jai Swaraj Party,1019,1,1020,S2911
3705,NADIMINTI SRINIVASULU,Independent,983,2,985,S2911
3706,M. NAVEEN REDDY,Independent,951,1,952,S2911
3707,VIJAYA,Independent,592,4,596,S2911
3708,ANEESUR RAHMAN,Bahujan Mukti Party,503,0,503,S2911
3709,A. SRINIVASULU,Independent,437,1,438,S2911
3710,KADINTI SHANKAR REDDY,Viduthalai Chiruthaigal Katchi,427,5,432,S2911
3711,NARESH REDDY,Telangana Jaghir Party,420,0,420,S2911
3712,VENKATA RAMANA,Independent,352,1,353,S2911
3713,BANDA SATYANARAYANA,Independent,263,1,264,S2911
3714,PULLANGARI SANDEEP KUMAR REDDY,Independent,261,1,262,S2911
3715,VISHNU VARDHAN REDDY THAPALAKINDHI,Independent,227,2,229,S2911
3716,MUDAVATH BALARAJU NAIK,Independent,181,2,183,S2911
3717,NOTA,None of the Above,4286,44,4330,S2911
3718,BHUMARE SANDIPANRAO ASARAM,Shiv Sena,474434,1696,476130,S1319
3719,IMTIAZ JALEEL SYED,All India Majlis-E-Ittehadul Muslimeen,340877,603,341480,S1319
3720,CHANDRAKANT KHAIRE,Shiv Sena (Uddhav Balasaheb Thackrey),291870,1580,293450,S1319
3721,AFSAR KHAN YASEEN KHA,Vanchit Bahujan  Aaghadi,69087,179,69266,S1319
3722,HARSHWARDHAN DADA RAIBHANJI JADHAV,Independent,39654,174,39828,S1319
3723,SURENDRA DIGAMBAR GAJBHARE,Independent,10719,6,10725,S1319
3724,SANJAY UTTAMRAO JAGTAP,Bahujan Samaj Party,8188,64,8252,S1319
3725,RAVINDRA BHASKARRAO BODKHE,Bharatiya Yuva Jan Ekta Party,6250,4,6254,S1319
3726,ABDUL AZIM ABDUL AZIZ SHAIKH,Independent,4693,0,4693,S1319
3727,SANJAY BHASKAR SHIRSAT,Independent,3809,3,3812,S1319
3728,DR JIVAN BHAWLAL RAJPUT,Independent,3788,19,3807,S1319
3729,MANISHA KHARAT,Bahujan Maha Party,3097,8,3105,S1319
3730,JAGANNATH KHANDERAO JADHAV J K JADHAV,Independent,2916,16,2932,S1319
3731,MAANOJ VINAYAKRAO GHODKAY,Independent,2582,5,2587,S1319
3732,SANGITA GANESH JADHAV,Independent,2206,6,2212,S1319
3733,GALPHADE ARJUN BHAGWANRAO,Rashtriya Kisan Bahujan Party,2185,7,2192,S1319
3734,VISHAL UDDHAV NANDARKAR,Independent,2132,7,2139,S1319
3735,ARVIND KISANRAO KAMBLE,Bahujan Republican  Socialist Party,1975,4,1979,S1319
3736,PRASHANT PUNDALIKRAO AVHALE,Independent,1945,3,1948,S1319
3737,GHUGE NITIN PUNDLIK,Independent,1870,2,1872,S1319
3738,BHALERAO VASANT SAMBHAJI,Prabuddha Republican Party,1546,1,1547,S1319
3739,BHARAT PURUSHOTTAM KADAM,Rashtriya Maratha Party,1489,6,1495,S1319
3740,ABDUL SAMAD BAGWAN,All India Majlis-E-Inquilab-E-Millat,1478,4,1482,S1319
3741,SANDIP DADARAO MANKAR,Independent,1373,2,1375,S1319
3742,ADV B U GOSAWI,Hindustan Janta Party,1271,4,1275,S1319
3743,PANCHASHILA BABULAL JADHAV,Republican Bahujan Sena,1267,7,1274,S1319
3744,PRATIKSHA PRASHANT CHAVAN,Ambedkarist Republican Party,1187,7,1194,S1319
3745,BHANUDAS SON OF RAMDAS SARODE PATIL,Independent,1107,3,1110,S1319
3746,NARAYAN JADHAV,Peoples Party of India (Democratic),1100,3,1103,S1319
3747,SURESH ASARAM FULARE,Independent,910,1,911,S1319
3748,SHAIKH KHAJA KISMATWALA KASIM KISMATWALA,Independent,892,2,894,S1319
3749,MEENASING AVDHESHSING SING,Independent,783,1,784,S1319
3750,LATIF JABBAR KHAN,Independent,765,0,765,S1319
3751,JAGANNATH KISAN UGALE,Independent,753,2,755,S1319
3752,SANDIP DEVIDAS JADHAV,Independent,609,0,609,S1319
3753,DEVIDAS RATAN KASBE,Independent,595,0,595,S1319
3754,TRIBHUVAN MADHUKAR PADMAKAR,Independent,593,0,593,S1319
3755,NOTA,None of the Above,5729,44,5773,S1319
3756,HARSIMRAT KAUR BADAL,Shiromani Akali Dal,375019,1539,376558,S1911
3757,GURMEET SINGH KHUDIAN,Aam Aadmi Party,325019,1883,326902,S1911
3758,JEETMOHINDER SINGH SIDHU,Indian National Congress,200859,1152,202011,S1911
3759,PARAMPAL KAUR SIDHU,Bharatiya Janata Party,110255,507,110762,S1911
3760,LAKHVIR SINGH LAKHA SIDHANA,Shiromani Akali Dal (Amritsar)(Simranjit Singh Mann),84222,462,84684,S1911
3761,NIKKA SINGH,Bahujan Samaj Party,12979,60,13039,S1911
3762,JAGJIWAN BALLI,Independent,5480,4,5484,S1911
3763,PARWINDER SINGH,Independent,4494,3,4497,S1911
3764,PALA RAM,Independent,3428,7,3435,S1911
3765,BHAGWANT SINGH SAMAON,Independent,3372,16,3388,S1911
3766,GURMEET SINGH,Independent,3072,10,3082,S1911
3767,JASVIR SINGH BATHINDA,Aazad Samaj Party (Kanshi Ram),3039,106,3145,S1911
3768,GURPREET SINGH URF PREET GHAINT,Jan Sewa Driver Party,2619,9,2628,S1911
3769,GURBARN SINGH,Independent,1618,9,1627,S1911
3770,NAIB SINGH,Bharatheeya Jawan Kisan Party,1593,8,1601,S1911
3771,KULWANT SINGH,Independent,1172,10,1182,S1911
3772,AMANDEEP SINGH,Independent,1146,2,1148,S1911
3773,POONAM RANI,Nationalist Justice Party,1060,4,1064,S1911
3774,NOTA,None of the Above,4818,115,4933,S1911
3775,DR CHANDRA SEKHAR PEMMASANI,Telugu Desam,851020,13928,864948,S0113
3776,KILARI VENKATA ROSAIAH,Yuvajana Sramika Rythu Congress Party,513563,6690,520253,S0113
3777,JANGALA AJAY KUMAR,Communist Party of India,8317,320,8637,S0113
3778,SIVAREDDY. ENDREDDY,Navataram Party,5628,1,5629,S0113
3779,TENALI PRAKASH,Bahujan Samaj Party,4172,100,4272,S0113
3780,SIKHAKOLLI HEMA GOWRI SHANKAR,Jatiya Jana Sena Party,1959,5,1964,S0113
3781,SAMUDRALA CHINNA KOTAIAH,Jaibhim Rao Bharat Party,1748,5,1753,S0113
3782,UMAR BHASHA SHAIK,Jana Sahayaka Sakthi,1273,2,1275,S0113
3783,SYED. SAIDA,Navarang Congress Party,1216,6,1222,S0113
3784,AMBATI CHALAMAIAH,Pyramid Party of India,1029,2,1031,S0113
3785,PILLI BABU RAO,Independent,688,4,692,S0113
3786,HARI VENKATA SATISH  KURNALA,Jai Bharat National Party,540,2,542,S0113
3787,VISHNU REDDY LANKIREDDY,Bengaluru Nava Nirmana Party,461,0,461,S0113
3788,EMANI. CHANDRASEKHAR RAO,Navodayam Party,409,5,414,S0113
3789,SHAIK. KHAJAVALI,Independent,387,4,391,S0113
3790,CHALLAPALLI RATAN RAJU,Viduthalai Chiruthaigal Katchi,374,4,378,S0113
3791,KANNEBOYINA VAMSI KRISHNA YADAV,Independent,368,7,375,S0113
3792,MOHAMMAD KHAJA MOINUDDIN CHISTI PASHA,Andhra Pradesh Rashtra Samithi,353,5,358,S0113
3793,GAYATRI AUDHIPUDI,Independent,350,7,357,S0113
3794,ASHOK ANAND GALI,Independent,335,0,335,S0113
3795,SHAIK ASLAM AKTHER,Independent,334,1,335,S0113
3796,PATHAN KHAJA (BASHA),Telugu Rajadhikara Samiti Party,328,4,332,S0113
3797,AMARTHALURI VENKATESWARA RAO.,Marxist Communist Party of India (United),308,4,312,S0113
3798,DR. RAYAPUDI RAJESH VIJAY KUMAR,Indian Labour Party (Ambedkar Phule),306,4,310,S0113
3799,BURAGA RATNAM,Loktantrik Janta Dal,304,12,316,S0113
3800,VANKAYALAPATI VENKATA SIVA RAMANJANEYULU,Independent,268,0,268,S0113
3801,SIVA PARVATHI,Independent,262,4,266,S0113
3802,BOMMASANI MUTYALA RAO,All Peoples Party,200,7,207,S0113
3803,SRIKRISHNA AKKISETTI,Independent,179,0,179,S0113
3804,MADAVARAPU NAGA RAJU,Independent,172,0,172,S0113
3805,NOTA,None of the Above,7210,177,7387,S0113
3806,GOVIND MAKTHAPPA KARJOL,Bharatiya Janata Party,681217,3673,684890,S1018
3807,B.N.CHANDRAPPA,Indian National Congress,634152,2617,636769,S1018
3808,ASHOKA CHAKRAVARTHI,Bahujan Samaj Party,7679,26,7705,S1018
3809,NARASIMHARAJU. C.N.,Karnataka Rashtra Samithi,4932,18,4950,S1018
3810,SRINIVASAPURADA SRINIVASABABU PAVAGADA,Independent,4539,9,4548,S1018
3811,"B. VENKATESHA, SHILPI",Independent,4196,5,4201,S1018
3812,MANJUNATHA SWAMY T,Independent,2652,24,2676,S1018
3813,BHUTHARAJA. V.S.,Independent,2386,11,2397,S1018
3814,RAGHU KUMAR .S,Independent,2318,19,2337,S1018
3815,RAMESH NAIK .T.,Uttama Prajaakeeya Party,2187,19,2206,S1018
3816,NAGARAJAPPA,Independent,1674,5,1679,S1018
3817,K  NARASHIMAMURTHY,Independent,1385,12,1397,S1018
3818,SUDHAKARA .R,Independent,1201,10,1211,S1018
3819,TULASI.H,Independent,1065,17,1082,S1018
3820,GANESH.,Independent,1048,45,1093,S1018
3821,SHABAREESH.,Karunada Sevakara Party,1014,4,1018,S1018
3822,SUJATHA .D.,Socialist Unity Centre Of India (COMMUNIST),996,18,1014,S1018
3823,DR M.P. DARAKESWARAIAH,Independent,982,10,992,S1018
3824,AMRUTH RAJA.,Independent,804,30,834,S1018
3825,B.T. RAMASUBBAIAH,Indian Movement Party,718,2,720,S1018
3826,NOTA,None of the Above,3156,34,3190,S1018
3827,PRADYUT BORDOLOI,Indian National Congress,786620,2230,788850,S039
3828,SURESH BORAH,Bharatiya Janata Party,573579,3040,576619,S039
3829,AMINUL ISLAM,All India United Democratic Front,137033,307,137340,S039
3830,SIKHA SARMA,Independent,6569,51,6620,S039
3831,SAMSUL ALAM,Independent,5048,21,5069,S039
3832,BIPAD BHANJAN SARKAR,Independent,4878,7,4885,S039
3833,ANUPAM BARUAH,Jai Prakash Janata Dal,4290,29,4319,S039
3834,NIKHIL DEKARAJA,Independent,3601,26,3627,S039
3835,RABBUL HAQUE,Rashtriya Ulama Council,2547,12,2559,S039
3836,ABU SHAMA,Independent,2216,22,2238,S039
3837,ABU EUSUF MD RAIHAN UDDIN,Independent,2019,11,2030,S039
3838,SANTANU MUKHERJEE,Bharatiya Gana Parishad,1993,17,2010,S039
3839,SAIFUL ISLAM CHOUDHURY,Asom Jana Morcha,1823,14,1837,S039
3840,NOTA,None of the Above,11910,85,11995,S039
3841,SELJA,Indian National Congress,732298,1525,733823,S073
3842,ASHOK TANWAR,Bharatiya Janata Party,464472,854,465326,S073
3843,SANDEEP LOT VALMIKI,Indian National Lok Dal,92279,174,92453,S073
3844,RAMESH KHATAK,Jannayak Janta Party,20049,31,20080,S073
3845,LILU RAM ASAKHERA,Bahujan Samaj Party,10120,31,10151,S073
3846,RAHUL CHOUHAN,Independent,6159,1,6160,S073
3847,KARNAIL SINGH ODHAN,Independent,4152,14,4166,S073
3848,SATPAL LADWAL,Independent,3413,0,3413,S073
3849,MISTRI DAULAT RAM ROLAN,Peoples Party of India (Democratic),3058,3,3061,S073
3850,JOGINDER RAM,Independent,2140,2,2142,S073
3851,RAN SINGH PANWAR,Independent,1548,2,1550,S073
3852,RAJINDER KUMAR,Bharatiya Asha Party,1239,3,1242,S073
3853,BAGDAWAT RAM,Independent,1221,3,1224,S073
3854,JASVIR SINGH,Independent,1128,8,1136,S073
3855,NAVEEN KUMAR COMMANDO,Independent,1113,3,1116,S073
3856,SUKHDEV SINGH SANDHU,Independent,993,6,999,S073
3857,DR. RAJESH MEHANDIA,Bahujan Republican  Socialist Party,931,0,931,S073
3858,DHARAMPAL VARTIA,Loktantrik Lok Rajyam Party,916,3,919,S073
3859,SURENDER KUMAR PHULAN,Independent,614,3,617,S073
3860,NOTA,None of the Above,4106,17,4123,S073
3861,DR. RAJESH MISHRA,Bharatiya Janata Party,582664,895,583559,S1211
3862,KAMLESHWAR INDRAJIT KUMAR,Indian National Congress,376336,807,377143,S1211
3863,AJAY PRATAP SINGH,Gondvana Gantantra Party,50897,65,50962,S1211
3864,PUJAN RAM SAKET (BABBU),Bahujan Samaj Party,33617,39,33656,S1211
3865,LAXMAN SINGH BAIS,Independent,30634,28,30662,S1211
3866,SANJAY NAMDEO,Communist Party of India,20284,6,20290,S1211
3867,BHAGWAN PRASAD TIWARI,Independent,7330,1,7331,S1211
3868,SUNIL TIWARI,Independent,5694,5,5699,S1211
3869,SHYAMLAL VAISH,Bhartiya Shakti Chetna Party,5340,3,5343,S1211
3870,KAILASH PRASAD VERMA,Independent,5289,2,5291,S1211
3871,MAHENDRA BHAIYA,Independent,4658,0,4658,S1211
3872,DASHRATH PRASAD BAIS,Independent,4131,0,4131,S1211
3873,"NARAYAN DAS SHAH ""MULNIWASI""",Peoples Party of India (Democratic),3791,1,3792,S1211
3874,DADDI YADAV,Independent,3301,4,3305,S1211
3875,SMT. TARA DEVI SINGH,Rashtriya Jansanchar Dal,2701,6,2707,S1211
3876,RAMSAHAY SAHU,Aapka Gantantra Party,2430,2,2432,S1211
3877,RAMVISHAL KOL,Rashtriya Samaj Paksha,2079,8,2087,S1211
3878,NOTA,None of the Above,4212,4,4216,S1211
3879,DILIP SAIKIA,Bharatiya Janata Party,864583,3804,868387,S034
3880,MADHAB RAJBANGSHI,Indian National Congress,538032,1343,539375,S034
3881,DURGADAS BORO,Bodoland Peoples Front,309040,1534,310574,S034
3882,DANIEL MARDI,Independent,14277,14,14291,S034
3883,AROON BAROOA,Bharatheeya Jawan Kisan Party,12519,44,12563,S034
3884,SWARNA DEVI,Gana Suraksha Party,11067,45,11112,S034
3885,LALIT PEGU,Voters Party  International,10887,28,10915,S034
3886,JITENDRA CHALIHA,Socialist Unity Centre Of India (COMMUNIST),7421,31,7452,S034
3887,ABUL KASEM,Republican Party of India (Athawale),4956,17,4973,S034
3888,BIREN BASAK,Bharatiya Gana Parishad,4605,18,4623,S034
3889,ABDUL HAMED,Rashtriya Ulama Council,3721,10,3731,S034
3890,NOTA,None of the Above,23086,118,23204,S034
3891,DAYANIDHI MARAN,Dravida Munnetra Kazhagam,412286,1562,413848,S224
3892,VINOJ,Bharatiya Janata Party,168059,1100,169159,S224
3893,B. PARTHASARATHY,Desiya Murpokku Dravida Kazhagam,71772,244,72016,S224
3894,DR.R.KARTHIKEYAN,Naam Tamilar Katchi,45865,166,46031,S224
3895,ANBAZHAGAN.G,Independent,3175,11,3186,S224
3896,DILAVAR ALI,Tipu Sultan Party,2536,10,2546,S224
3897,SAMARAN,Bahujan Samaj Party,2132,15,2147,S224
3898,L.KASINATHAN,Independent,1059,1,1060,S224
3899,AGNI AALVAR,Independent,783,4,787,S224
3900,C.S.KARNAN,Anti Corruption Dynamic Party,750,11,761,S224
3901,M.L.RAVI,Desiya Makkal Sakthi Katchi,690,6,696,S224
3902,S.KANDASAMY,Independent,595,1,596,S224
3903,DHAYANIDHI SURESH,Independent,565,2,567,S224
3904,S.SATHISH KUMAR,Independent,526,1,527,S224
3905,P.ARJUNAN,Independent,502,7,509,S224
3906,S.SATHISH KUMAR,Independent,500,1,501,S224
3907,G.OMPRAKASH,Independent,486,2,488,S224
3908,V.V.TAMILARASAN,Independent,386,3,389,S224
3909,UDAYA KUMAR.V,Independent,382,0,382,S224
3910,B.PARTHASARATHY,Independent,377,3,380,S224
3911,K.CHANDRASEKAR,Naadaalum Makkal Katchi,373,0,373,S224
3912,N.RAMAN,Tamilnadu Makkal Nalvazhvu Periyakkam,311,3,314,S224
3913,R.MINNAL RAJ,Independent,310,0,310,S224
3914,R.VIJAY,Independent,268,0,268,S224
3915,A.SELVA KUMAR,Thakkam Katchi,265,5,270,S224
3916,M.NAGARAJ,Independent,254,0,254,S224
3917,J.NAGARAJ,Independent,238,3,241,S224
3918,SENTHILKUMAR,Chennai Youth Party,222,1,223,S224
3919,RANJITHKUMAR.S,Independent,215,0,215,S224
3920,RAVI BALARAMAN,Independent,182,1,183,S224
3921,MANJUNATHA.R,Independent,159,0,159,S224
3922,NOTA,None of the Above,11082,81,11163,S224
3923,CHANDRA PRAKASH JOSHI,Bharatiya Janata Party,882334,5868,888202,S2021
3924,ANJANA UDAILAL,Indian National Congress,495177,3148,498325,S2021
3925,BHIL ADIVASI MANGILAL NANAMA,Bharat Adivasi Party,42243,568,42811,S2021
3926,RAMESHWAR LAL BAIRWA (INDORA),Independent,9536,3,9539,S2021
3927,KUMAWAT RAMESH CHANDRA,Independent,8834,8,8842,S2021
3928,MEGHWAL RADHESHYAM,Bahujan Samaj Party,8578,35,8613,S2021
3929,SHYAM LAL MEGHWAL,Independent,7901,6,7907,S2021
3930,BAPU LAL ANJANA,Independent,7837,9,7846,S2021
3931,PRAKASH DHAKAR,Ekam Sanatan Bharat Dal,3915,10,3925,S2021
3932,PRATAP SINGH,Independent,3342,5,3347,S2021
3933,AZAD PRAKASH CHANDRA MEGHWAL,Akhil Bharatiya Congress Dal (Ambedkar),2764,13,2777,S2021
3934,JOGENDRA SINGH HODA,Independent,2294,8,2302,S2021
3935,GAJENDRA,Independent,1637,7,1644,S2021
3936,KALYAN SINGH BHATI,Independent,1544,18,1562,S2021
3937,MAHAVIR PRASAD KUMAWAT,Right to Recall Party,1539,10,1549,S2021
3938,KAMAL,Independent,1490,8,1498,S2021
3939,MOHAMMAD WAHID KHAN,Pehchan People’s Party,1216,12,1228,S2021
3940,SITA RAM AHIR,Vishva Shakti Party,1203,23,1226,S2021
3941,NOTA,None of the Above,5518,72,5590,S2021
3942,BABU SINGH KUSHWAHA,Samajwadi Party,506076,3054,509130,S2473
3943,KRIPASHANKAR SINGH,Bharatiya Janata Party,408512,1283,409795,S2473
3944,SHYAM SINGH YADAV,Bahujan Samaj Party,156691,446,157137,S2473
3945,SARFARAZ AHMAD,Independent,2750,0,2750,S2473
3946,ASHOK SINGH,Samaj Vikas Kranti Party,2749,6,2755,S2473
3947,JIYALAL PRAJAPATI,Bhagidari Party(P),2232,3,2235,S2473
3948,SHRIPATI MAURYA,Independent,2091,3,2094,S2473
3949,SHAH ALAM,Apna Dal (Kamerawadi),2003,0,2003,S2473
3950,FULACHANDR,Moulik Adhikar Party,1632,1,1633,S2473
3951,KRIPASHANKAR C PANDEY,Independent,1446,1,1447,S2473
3952,GOVIND LAL,Independent,1387,2,1389,S2473
3953,RAM PYARE,Socialist Unity Centre Of India (COMMUNIST),1160,1,1161,S2473
3954,NISHA PATEL,Sardar Patel Siddhant Party,1125,3,1128,S2473
3955,BHARAT RAM,Pachchasi Parivartan Samaj Party,802,0,802,S2473
3956,NOTA,None of the Above,6301,28,6329,S2473
3957,SURESH KUMAR SHETKAR,Indian National Congress,523919,4499,528418,S295
3958,B. B. PATIL,Bharatiya Janata Party,476023,6207,482230,S295
3959,ANILKUMAR GALI,Bharat Rashtra Samithi,171412,666,172078,S295
3960,KOTHA BALIJA BASWARAJ,Telangana Praja Shakthi Party,8362,11,8373,S295
3961,CHAVAGANI MANI,Alliance of Democratic Reforms Party,6295,14,6309,S295
3962,YAKUB SHARIF MD,Independent,5484,5,5489,S295
3963,MAHADHEV SWAMI MATAM,Independent,5408,4,5412,S295
3964,B. MARUTHI RAO,Independent,4248,4,4252,S295
3965,S. RAJU,Independent,3511,3,3514,S295
3966,SATYANARAYANA GOUD KOVURI,Independent,2875,1,2876,S295
3967,RAMESH. SAJJAPUR.,Independent,2477,2,2479,S295
3968,KAMMARI ANANDEESHWAR,Independent,2381,3,2384,S295
3969,JAIPAL NAYAK JADAVATH,Independent,2217,51,2268,S295
3970,GURRAPU MACHANDER,All India Forward Bloc,1760,9,1769,S295
3971,T.D.S. MANI,Dharma Samaj Party,1628,27,1655,S295
3972,MOHD SADDAM,Independent,1567,1,1568,S295
3973,MALEPU MOHAN REDDY,Pyramid Party of India,1095,7,1102,S295
3974,ASHOK TALARI,Independent,831,6,837,S295
3975,ROMALA BABU DURGAIAH,India Praja Bandhu Party,601,2,603,S295
3976,NOTA,None of the Above,2933,44,2977,S295
3977,NISHIKANT DUBEY,Bharatiya Janata Party,688879,4261,693140,S273
3978,PRADEEP YADAV,Indian National Congress,586104,5223,591327,S273
3979,UDAY SHANKAR KHAWARE,Independent,26831,6,26837,S273
3980,ARUN MARIK,Independent,17436,1,17437,S273
3981,NILESH KUMAR GUPTA,Independent,10485,3,10488,S273
3982,AVISEK ANAND JHA,Independent,9601,35,9636,S273
3983,BAJRANGI MAHTHA,Bahujan Samaj Party,8151,24,8175,S273
3984,MUKESH KUMAR JHA,Independent,7366,0,7366,S273
3985,KUMARI DILESHWARI,Ambedkarite Party of India,6578,3,6581,S273
3986,RAMESHWAR MANDAL,Peoples Party of India (Democratic),3315,1,3316,S273
3987,SURAJ KUMAR AMAN,Bhagidari Party(P),3070,3,3073,S273
3988,ARUN KUMAR,Nyaydharmsabha,2891,2,2893,S273
3989,DR. K. RANGAIAH,Independent,2205,5,2210,S273
3990,BRAJKISHORE PANDIT,Akhil Bhartiya Manavadhikar Vichar Manch Party,2102,6,2108,S273
3991,ANUP KUMAR,"Proutist Bloc, India",2003,4,2007,S273
3992,KALIPADA MURMU,Socialist Unity Centre Of India (COMMUNIST),1935,6,1941,S273
3993,KETAN KUMAR,Right to Recall Party,1896,2,1898,S273
3994,TIPLAL SAH,Lokhit Adhikar Party,1765,5,1770,S273
3995,GYANESHWAR JHA,Jagrook Janta Party,1637,3,1640,S273
3996,NOTA,None of the Above,4309,52,4361,S273
3997,ADHIKARI DEEPAK (DEV),All India Trinamool Congress,834558,3432,837990,S2532
3998,DR. HIRANMOY CHATTOPADHYAYA,Bharatiya Janata Party,652098,3024,655122,S2532
3999,TAPAN GANGULI,Communist Party of India,74399,509,74908,S2532
4000,SOUMEN MADRAJI,Bahujan Samaj Party,7916,25,7941,S2532
4001,GOPAL MONDAL,Independent,4238,6,4244,S2532
4002,DINESH MAIKAP,Socialist Unity Centre Of India (COMMUNIST),4124,24,4148,S2532
4003,SAHEB CHOWDHURY,Independent,3228,9,3237,S2532
4004,NOTA,None of the Above,12889,77,12966,S2532
4005,JYOTIRMAY SINGH MAHATO,Bharatiya Janata Party,576246,2243,578489,S2535
4006,SHANTIRAM MAHATO,All India Trinamool Congress,559325,2085,561410,S2535
4007,NEPAL CHANDRA MAHATO,Indian National Congress,128565,592,129157,S2535
4008,AJIT PRASAD MAHATA,Independent,98381,277,98658,S2535
4009,DHIRENDRANATH MAHATO,All India Forward Bloc,14498,74,14572,S2535
4010,SONTOSH RAJOWARD,Bahujan Samaj Party,7739,21,7760,S2535
4011,SUSMITA MAHATO,Socialist Unity Centre Of India (COMMUNIST),6078,31,6109,S2535
4012,GORISH ROY,Independent,4800,9,4809,S2535
4013,BHAGWAT DASS SHASTRI,Independent,4508,4,4512,S2535
4014,ASIT BARAN MAHATO,Party for Democratic Socialism,3868,9,3877,S2535
4015,PIJUSH KANTI RAJAK,Independent,3408,10,3418,S2535
4016,AJIT MAHATO,Independent,3309,9,3318,S2535
4017,NOTA,None of the Above,17871,58,17929,S2535
4018,SUDAMA PRASAD,Communist Party of India  (Marxist-Leninist)  (Liberation),526564,2818,529382,S0432
4019,R. K. SINGH,Bharatiya Janata Party,464736,4838,469574,S0432
4020,VIRENDRA KUMAR SINGH,Independent,23630,5,23635,S0432
4021,SHIV DAS SINGH,Independent,13373,6,13379,S0432
4022,LAL BADSAH SINGH,Bahujan Samaj Party,10631,195,10826,S0432
4023,KRISHNA PASWAN,Bhartiya Kranti Vir Party,8709,40,8749,S0432
4024,RANDHIR LAL,Independent,5765,1,5766,S0432
4025,NAVNIT KUMAR,Independent,4764,9,4773,S0432
4026,RAM SARE SINGH,Peoples Party of India (Democratic),2531,10,2541,S0432
4027,DHARMATMA SHARMA,Socialist Unity Centre Of India (COMMUNIST),2449,18,2467,S0432
4028,RAMJEE SINGH,Voters Party  International,2435,5,2440,S0432
4029,ASHOK TIWARY,Independent,2263,32,2295,S0432
4030,MANMOHAN SINGH,Rashtrawadi Janlok Party (Satya),2055,42,2097,S0432
4031,SUMITRA DEVI,Jagrook Janta Party,1640,34,1674,S0432
4032,NOTA,None of the Above,16864,99,16963,S0432
4033,NAVEEN JINDAL,Bharatiya Janata Party,540677,1498,542175,S072
4034,DR SUSHIL GUPTA,Aam Aadmi Party,511770,1384,513154,S072
4035,ABHAY SINGH CHAUTALA,Indian National Lok Dal,78362,346,78708,S072
4036,DEEPAK MEHRA,Bahujan Samaj Party,20864,80,20944,S072
4037,JAI KUMAR  SAINI HAMIDPUR,Independent,8090,3,8093,S072
4038,PALA RAM SAINI,Jannayak Janta Party,6159,23,6182,S072
4039,SATBIR KASHYAP,Rashtriya Janshakti Party(Eklavya),3251,12,3263,S072
4040,KHAZAN SINGH SEHGAL,Shiromani Akali Dal (Amritsar)(Simranjit Singh Mann),2824,35,2859,S072
4041,MAHAVIR SINGH,Ekam Sanatan Bharat Dal,2779,4,2783,S072
4042,INDERJEET KAMBOJ,Peoples Party of India (Democratic),2107,6,2113,S072
4043,PANDIT ANIL UPADHYAY,Independent,2053,3,2056,S072
4044,ADV ASHWINI SHARMA HRITTWAL,Independent,2027,2,2029,S072
4045,COMRADE OM PARKASH SHASTRI,Socialist Unity Centre Of India (COMMUNIST),1806,6,1812,S072
4046,SURENDER SINGH,Independent,1599,0,1599,S072
4047,AMIT MALIK,Independent,1503,3,1506,S072
4048,PATASHO DEVI EX-SARPANCH,Independent,1379,0,1379,S072
4049,DR MAHESH CHAND GAUR,Independent,1338,2,1340,S072
4050,JAI PARKASH SHARMA,Independent,1152,2,1154,S072
4051,VARUN GUPTA,Independent,1129,5,1134,S072
4052,SATNAM BHAZIGAR,Loktantrik Lok Rajyam Party,1063,3,1066,S072
4053,NARESH KUMAR,Samata Party,1028,4,1032,S072
4054,SATISH DHULL,Bharatiya Asha Party,991,6,997,S072
4055,ADVOCATE PARDEEP SAINI,Rashtriya Garib Dal,958,2,960,S072
4056,SEWA SINGH,Independent,717,1,718,S072
4057,ER VISHAL KUMAR,Independent,715,0,715,S072
4058,COMRADE RAMESH KHATKAR,Independent,714,3,717,S072
4059,OM PARKASH INDAL,Global Republican Party,675,3,678,S072
4060,PHOOL SINGH,Independent,625,1,626,S072
4061,SUNNY KASHYAP TEORA,Independent,576,0,576,S072
4062,RAMDIYA,Independent,553,3,556,S072
4063,MANGAT RAM,Independent,509,0,509,S072
4064,NOTA,None of the Above,2420,19,2439,S072
4065,AVIMANYU SETHI,Bharatiya Janata Party,569705,3614,573319,S187
4066,MANJULATA MANDAL,Biju Janata Dal,480105,1670,481775,S187
4067,ANANTA PRASAD SETHI,Indian National Congress,221020,854,221874,S187
4068,KIRTAN BIHARI MALIK,Socialist Unity Centre Of India (COMMUNIST),4879,1,4880,S187
4069,ADV. ARJUN CHARAN MALLIK,Bahujan Samaj Party,3581,23,3604,S187
4070,ANJAN DAS,Ambedkarite Party of India,3512,5,3517,S187
4071,BASANTA KUMAR MAHALIK,Independent,1527,3,1530,S187
4072,SARBESWAR BEHERA,Independent,1397,3,1400,S187
4073,NOTA,None of the Above,5457,21,5478,S187
4074,MITESH PATEL (BAKABHAI),Bharatiya Janata Party,607394,5090,612484,S0616
4075,AMIT CHAVDA,Indian National Congress,516453,6092,522545,S0616
4076,SURESHBHAI DHULABHAI PATEL,Bahujan Samaj Party,5778,53,5831,S0616
4077,BHOI ASHISHKUMAR THAKORBHAI,Independent,5525,17,5542,S0616
4078,KEYURBHAI PRAVINBHAI PATEL (BAKABHAI),Independent,2290,8,2298,S0616
4079,DHEERAJKUMAR KSHATRIYA,Garib Kalyan Party,1723,24,1747,S0616
4080,BHATT SUNILKUMAR NARENDRABHAI,Right to Recall Party,1584,8,1592,S0616
4081,NOTA,None of the Above,15679,251,15930,S0616
4082,APARAJITA SARANGI,Bharatiya Janata Party,509567,2952,512519,S1818
4083,MANMATH KUMAR ROUTRAY,Biju Janata Dal,475990,1377,477367,S1818
4084,SYED YASHIR NAWAZ,Indian National Congress,66045,317,66362,S1818
4085,SURESH CHANDRA PANIGRAHY,Communist Party of India  (Marxist),4134,14,4148,S1818
4086,HULAS SENAPATI,Independent,2248,3,2251,S1818
4087,KISHOR KUMAR SUTAR,Independent,2202,1,2203,S1818
4088,SUDHANSU SEKHAR DAS,Independent,1751,7,1758,S1818
4089,SANTOSH KUMAR MISHRA,Independent,1738,6,1744,S1818
4090,SANGEETA PATTANAIK,Odisha Janata Party,1528,2,1530,S1818
4091,PRADEEP KUMAR SAHOO,Kalinga Sena,1495,8,1503,S1818
4092,SANTILATA ROUT,Supreme Zero Party of Bharat,1437,4,1441,S1818
4093,NATABAR MAHARANA,Bharatiya Bikash Parishad,1080,7,1087,S1818
4094,NOTA,None of the Above,8261,41,8302,S1818
4095,RAKIBUL HUSSAIN,Indian National Congress,1468549,3336,1471885,S032
4096,MOHAMMED BADRUDDIN AJMAL,All India United Democratic Front,458202,1207,459409,S032
4097,ZABED ISLAM,Asom Gana Parishad,435822,2772,438594,S032
4098,S. M. JIAUL HAQUE,Bharatiya Gana Parishad,11978,128,12106,S032
4099,FARUK KHAN,Independent,10986,8,10994,S032
4100,BISWAJIT RAY,Independent,7615,88,7703,S032
4101,ALAKESH ROY,Independent,6950,40,6990,S032
4102,HAFIZ BURHANUDDIN,The National Road Map Party of India,6934,6,6940,S032
4103,RADHARANI BISWAS,Hindu Samaj Party,6137,150,6287,S032
4104,TAHIDUR RAHMAN,Voters Party  International,5384,8,5392,S032
4105,SHUKUR ALI,Asom Jana Morcha,4749,43,4792,S032
4106,SURAT ZAMAN MONDAL,Socialist Unity Centre Of India (COMMUNIST),3984,31,4015,S032
4107,REJAUL KARIM,Republican Party of India (Athawale),3481,5,3486,S032
4108,NOTA,None of the Above,14912,103,15015,S032
4109,GUMMA THANUJA RANI,Yuvajana Sramika Rythu Congress Party,471470,5535,477005,S011
4110,KOTHAPALLI GEETHA,Bharatiya Janata Party,417113,9312,426425,S011
4111,APPALANARASA PACHIPENTA,Communist Party of India  (Marxist),119016,4113,123129,S011
4112,AVASHYA LAHARI . VARAM,Bahujan Samaj Party,24858,892,25750,S011
4113,SAMAREDDY BALAKRISHNA,Independent,9493,42,9535,S011
4114,NIMMAKA JAYARAJU,Independent,8798,664,9462,S011
4115,ATHIDHI,Independent,8121,15,8136,S011
4116,CHANTI BADNAINA,Jai Bharat National Party,7205,47,7252,S011
4117,MOTTADAM . RAJABABU,Bharat Adivasi Party,6370,396,6766,S011
4118,RANJITH KUMAR PALAKA,Independent,6000,47,6047,S011
4119,RAMBABU JALLI,Telugu Rajadhikara Samiti Party,4933,26,4959,S011
4120,MANDALA GIRIDHARA RAO,Independent,4931,36,4967,S011
4121,VUYAKA NIREEKSHAN  (V. CHENCHU),India Praja Bandhu Party,4500,42,4542,S011
4122,NOTA,None of the Above,50205,265,50470,S011
4123,SANGEETA KUMARI SINGH DEO,Bharatiya Janata Party,614196,3548,617744,S1810
4124,SURENDRA SINGH BHOI,Biju Janata Dal,483964,1116,485080,S1810
4125,MANOJ KUMAR MISHRA,Indian National Congress,229577,1297,230874,S1810
4126,SUNIL KUMAR BHOI,Socialist Unity Centre Of India (COMMUNIST),10334,21,10355,S1810
4127,JAGADISH CHANDRA BIBHAR,Bahujan Samaj Party,9404,65,9469,S1810
4128,BALRAM SINGH YADAV,Independent,8637,37,8674,S1810
4129,MADHUSUDAN BARIK,Ambedkarite Party of India,7239,13,7252,S1810
4130,BALARAM SA,Independent,6092,5,6097,S1810
4131,AKSHAYA DISHRI,National Apni Party,5465,4,5469,S1810
4132,RAJESH KUMAR PANDA,Ekam Sanatan Bharat Dal,3163,7,3170,S1810
4133,NOTA,None of the Above,16010,54,16064,S1810
4134,KRISHAN PAL,Bharatiya Janata Party,787332,1237,788569,S0710
4135,MAHENDER PRATAP SINGH,Indian National Congress,614908,747,615655,S0710
4136,KISHAN THAKUR,Bahujan Samaj Party,25164,42,25206,S0710
4137,SUNIL TEWATIA,Indian National Lok Dal,8057,28,8085,S0710
4138,NALIN HOODA,Jannayak Janta Party,5335,26,5361,S0710
4139,SAWATANTAR SINGH CHAUHAN,Jan Shakti Dal,2951,4,2955,S0710
4140,NEERAJ JATAV,Independent,2104,4,2108,S0710
4141,HARI SHANKER RAJVANS,Adim Bhartiya Dal,1584,0,1584,S0710
4142,ATUL,Independent,1456,2,1458,S0710
4143,PANDIT SUMIT KUMAR SHARMA,AARAKSHAN VIRODHI PARTY,1439,5,1444,S0710
4144,BRIJABALA,Peoples Party of India (Democratic),1370,10,1380,S0710
4145,SHYAM SUNDER SINGH,Bhartiya Shakti Chetna Party,1247,0,1247,S0710
4146,MAHESH PRATAP SHARMA,Rashtriya Vikas Party,1237,3,1240,S0710
4147,SATAY DEO YADAV,Buland Bharat Party,953,2,955,S0710
4148,RANDHEER SINGH ALIAS DHEERU KHATANA,Akhil Bhartiya Kisan Majdoor Party,919,5,924,S0710
4149,SUNIL KUMAR,Independent,888,1,889,S0710
4150,BHARAT BHUSHAN KOLI,Rashtra Nirman Party,807,1,808,S0710
4151,SHIV NARAYAN BABA DUBEY,Kisan Mazdoor Sangharsh Party,769,2,771,S0710
4152,GYAN CHAND BAINSLA,Samrat Mihir Bhoj Samaj Party,751,5,756,S0710
4153,RAJESH GAUTAM,Independent,662,1,663,S0710
4154,SWAMI RAJENDRA DEV JI,Independent,660,3,663,S0710
4155,GIRRAJ,Independent,612,2,614,S0710
4156,LEKHRAM DABANG,Independent,610,5,615,S0710
4157,SHAKILA HUSSAIN,Loktantrik Janshakti Party,547,4,551,S0710
4158,NOTA,None of the Above,6808,13,6821,S0710
4159,SAVITRI THAKUR,Bharatiya Janata Party,792591,1858,794449,S1225
4160,RADHESHYAM MUVEL,Indian National Congress,574756,1028,575784,S1225
4161,DHUMSINGH MANDLOI MACHHAR,Bahujan Samaj Party,14926,30,14956,S1225
4162,JITENDRA MUNIYA,Bharat Adivasi Party,10586,35,10621,S1225
4163,SUNIL AJRAWAT,Independent,5400,8,5408,S1225
4164,SHIVAJI PATEL KALMI,Independent,4694,6,4700,S1225
4165,VIKRAM VASUNIYA,Janata Congress,3464,11,3475,S1225
4166,NOTA,None of the Above,15612,39,15651,S1225
4167,DELKAR KALABEN MOHANBHAI,Bharatiya Janata Party,120833,241,121074,U032
4168,AJIT RAMJIBHAI MAHALA,Indian National Congress,63423,67,63490,U032
4169,KURADA DEEPAKBHAI,Bharat Adivasi Party,10188,9,10197,U032
4170,BORSA SANDIPBHAI S,Bahujan Samaj Party,3147,5,3152,U032
4171,SHAILESHBHAI VARTHA,Independent,2522,2,2524,U032
4172,NOTA,None of the Above,5144,7,5151,U032
4173,UMMEDA RAM BENIWAL,Indian National Congress,699122,5554,704676,S2017
4174,RAVINDRA SINGH BHATI,Independent,581865,4635,586500,S2017
4175,KAILASH CHOUDHARY,Bharatiya Janata Party,284527,2206,286733,S2017
4176,TARARAM MEHNA,Independent,49768,189,49957,S2017
4177,PRATAPA RAM,Independent,8282,36,8318,S2017
4178,HANIPH,Independent,7755,5,7760,S2017
4179,LEELA RAM,Bahujan Samaj Party,7557,28,7585,S2017
4180,PRABHU RAM,Aazad Samaj Party (Kanshi Ram),6381,15,6396,S2017
4181,RAMA RAM,Independent,6031,10,6041,S2017
4182,POPAT LAL,Independent,3117,42,3159,S2017
4183,DEVILAL JAIN,Independent,3016,7,3023,S2017
4184,NOTA,None of the Above,17893,10,17903,S2017
4185,SUKHJINDER SINGH RANDHAWA,Indian National Congress,361713,2330,364043,S191
4186,DINESH SINGH BABBU,Bharatiya Janata Party,278701,2481,281182,S191
4187,AMANSHER SINGH (SHERY KALSI),Aam Aadmi Party,275416,1836,277252,S191
4188,DR. DALJIT SINGH CHEEMA,Shiromani Akali Dal,85194,306,85500,S191
4189,GURINDER SINGH BAJWA,Shiromani Akali Dal (Amritsar)(Simranjit Singh Mann),25425,340,25765,S191
4190,SANT SEWAK,Independent,5950,2,5952,S191
4191,RAJ KUMAR,Bahujan Samaj Party,4859,71,4930,S191
4192,SANTOSH KAUR,Independent,4733,5,4738,S191
4193,SAMUEL SONI,Independent,4427,13,4440,S191
4194,SURJIT SINGH,Independent,3372,1,3373,S191
4195,SANJEEV SINGH,Independent,2172,6,2178,S191
4196,SURINDER SINGH,Independent,1775,7,1782,S191
4197,GURPREET KAUR BAJWA,Independent,1688,21,1709,S191
4198,SANJEEV MANHAS,Independent,1634,1,1635,S191
4199,ROBI MASIH,Independent,1509,2,1511,S191
4200,SANTOSH KUMARI,Megh Desham Party,1171,23,1194,S191
4201,RAMESH KUMAR TOLLA,Bharatheeya Jawan Kisan Party,1085,13,1098,S191
4202,AMIT AGGARWAL,Independent,920,4,924,S191
4203,TARSEM MASIH SAHOTA,Independent,878,7,885,S191
4204,TILAK RAJ,Independent,802,3,805,S191
4205,RANJODH SINGH,Jan Sewa Driver Party,776,13,789,S191
4206,I.S.GULATI,Independent,696,3,699,S191
4207,RAMESH LAL,National Republic Party Of India,653,4,657,S191
4208,JAGDISH MASIH,Independent,545,1,546,S191
4209,JATINDER KUMAR SHARMA,Bhartiya Rashtriya Dal,456,5,461,S191
4210,DARBARA SINGH,Nationalist Justice Party,415,9,424,S191
4211,NOTA,None of the Above,3289,65,3354,S191
4212,JAGADISH SHETTAR,Bharatiya Janata Party,756471,5558,762029,S102
4213,MRINAL R HEBBALKAR,Indian National Congress,580897,2695,583592,S102
4214,MAHADEV PATIL,Independent,9425,78,9503,S102
4215,BASAPPA GURUSIDDAPPA KUMBAR,Karnataka Rashtra Samithi,5406,35,5441,S102
4216,ASHOK APPAYA APPUGOL,Bahujan Samaj Party,4350,57,4407,S102
4217,RAVI SHIVAPPA PADASALAGI,Independent,3911,15,3926,S102
4218,VIJAY S METHRANI,Independent,2804,4,2808,S102
4219,PRAJAAKEEYA MALLAPPA CHOGALA (PREM),Uttama Prajaakeeya Party,1413,20,1433,S102
4220,LAXMAN JADAGANNAVAR,Socialist Unity Centre Of India (COMMUNIST),1287,15,1302,S102
4221,NITIN ASHOK MHADAGUT,Independent,1286,24,1310,S102
4222,PUNDALIK ITNAL,Independent,1062,37,1099,S102
4223,ASHOK P HANAJI,Independent,668,11,679,S102
4224,ASHPAKAHMAD USTAD,Independent,622,12,634,S102
4225,NOTA,None of the Above,5683,43,5726,S102
4226,SANATAN PANDEY,Samajwadi Party,464473,2595,467068,S2472
4227,NEERAJ SHEKHAR,Bharatiya Janata Party,421277,2407,423684,S2472
4228,LALLAN SINGH YADAV,Bahujan Samaj Party,84943,262,85205,S2472
4229,SUMESHWAR,Independent,5056,0,5056,S2472
4230,SHESHNATH,Independent,3587,1,3588,S2472
4231,RAVI KANT SINGH ALIAS RAVI PATEL,Sardar Patel Siddhant Party,3174,7,3181,S2472
4232,RAMNIVAS GOND,Gondvana Gantantra Party,2642,30,2672,S2472
4233,SURYA BALI PRASAD,Aazad Samaj Party (Kanshi Ram),2143,5,2148,S2472
4234,RANJANA,Independent,1871,7,1878,S2472
4235,ASHOK GUPTA,Independent,1339,8,1347,S2472
4236,MANINDR,Independent,1186,1,1187,S2472
4237,AVADHESH VERMA,Independent,1150,11,1161,S2472
4238,PRAKASH KUMAR,Independent,960,0,960,S2472
4239,NOTA,None of the Above,8167,20,8187,S2472
4240,DR C N MANJUNATH,Bharatiya Janata Party,1075553,3449,1079002,S1023
4241,D K SURESH,Indian National Congress,807459,1896,809355,S1023
4242,ABHISHEK K,Uttama Prajaakeeya Party,6191,11,6202,S1023
4243,SURESH M N,Independent,3231,5,3236,S1023
4244,HEMAVATHI K,Socialist Unity Centre Of India (COMMUNIST),1768,6,1774,S1023
4245,J T PRAKASH,Independent,1468,4,1472,S1023
4246,N KRISHNAPPA,Pyramid Party of India,1396,6,1402,S1023
4247,C N MANJUNATHA,Bahujan Bharat Party,1350,50,1400,S1023
4248,KUMAR L,Bharatiya Prajagala Kalyana Paksha,1052,14,1066,S1023
4249,MAHAMAD MUSADIK PASHA,Karnataka Rashtra Samithi,817,4,821,S1023
4250,NARASIMHAMURTHY J P,Independent,809,4,813,S1023
4251,SURESH S,Karunaadu Party,792,6,798,S1023
4252,VASIST J,Country Citizen Party,546,38,584,S1023
4253,MOHAMMAD DASTAGEER,Young Star Empowerment Party,486,0,486,S1023
4254,H V CHANDRASHEKAR,Viduthalai Chiruthaigal Katchi,473,7,480,S1023
4255,NOTA,None of the Above,10633,16,10649,S1023
4256,C.M.RAMESH,Bharatiya Janata Party,750027,12042,762069,S015
4257,BUDI MUTYALA NAIDU,Yuvajana Sramika Rythu Congress Party,459762,5777,465539,S015
4258,VEGI VENKATESH,Indian National Congress,24833,818,25651,S015
4259,PALAKA SREERAMA MURTHY,Bahujan Samaj Party,19082,75,19157,S015
4260,VANKAYALA RAMACHANDRA RAO,Independent,4001,1,4002,S015
4261,LOVARAJU SIDDHA,Independent,3845,7,3852,S015
4262,KRISHNA SWAROOP VADLAMURI,Dalita Bahujana Party,3549,8,3557,S015
4263,GARA SURYA RAO,Independent,3116,8,3124,S015
4264,APPALA RAJU NAMMI,Bharatha Chaitanya Yuvajana Party,2589,30,2619,S015
4265,NAGESWARA RAO PETLA,Independent,2179,5,2184,S015
4266,ADARI SARAT CHANDRA,Jai Bharat National Party,1886,27,1913,S015
4267,VIJAYA LAKSHMI KARRI,Pyramid Party of India,1578,13,1591,S015
4268,DR. THUMMAPALA HARI  SHANKAR,Independent,1567,9,1576,S015
4269,JUNNURI J SRINIVAS,Independent,1195,6,1201,S015
4270,APPALANAIDU TUMMAGUNTA,Independent,1055,7,1062,S015
4271,NOTA,None of the Above,26084,151,26235,S015
4272,PRADEEP PUROHIT,Bharatiya Janata Party,709606,6753,716359,S181
4273,PARINITA MISHRA,Biju Janata Dal,463008,1684,464692,S181
4274,SANJAY BHOI,Indian National Congress,92666,885,93551,S181
4275,JAYARAM BAGH,Bahujan Samaj Party,9215,107,9322,S181
4276,GNYANENDRA BEHERA,Independent,4539,24,4563,S181
4277,DEVIKA SIKA,National Apni Party,4524,14,4538,S181
4278,PRABHAT KUMAR DHARUA,Independent,4294,4,4298,S181
4279,NOTA,None of the Above,12414,127,12541,S181
4280,Y. S. AVINASH REDDY,Yuvajana Sramika Rythu Congress Party,598406,6737,605143,S0121
4281,CHADIPIRALLA BHUPESH SUBBARAMI REDDY,Telugu Desam,532358,10090,542448,S0121
4282,Y.S. SHARMILA REDDY,Indian National Congress,136395,4644,141039,S0121
4283,PANDITI. GURAPPA.,Bahujan Samaj Party,3790,20,3810,S0121
4284,VENU GOPAL RACHINENI,Rashtriya Praja Congress  (Secular),3500,70,3570,S0121
4285,CHINNAPUREDDY GOPALA KRISHNA REDDY,Independent,2414,16,2430,S0121
4286,KUNCHAM. VENKATA SUBBA REDDY,Rayalaseema Rashtra Samithi,2329,4,2333,S0121
4287,L. KHAJA HUSSAIN,Independent,1087,1,1088,S0121
4288,ANKIREDDY. SURESH KUMAR REDDY.,All India Forward Bloc,752,3,755,S0121
4289,KAKARLA SHANMUKHA REDDY,Independent,633,14,647,S0121
4290,PALLE RAMESH,Jaibhim Rao Bharat Party,619,5,624,S0121
4291,CHAN BASHA. S,Anna YSR Congress Party,432,7,439,S0121
4292,J. V. RAMANA,Jaathia Chethi Vruthula Ikya Vedika Party,414,20,434,S0121
4293,MALIKIREDDY. HANUMANTHA REDDY,Jana Sahayaka Sakthi,358,11,369,S0121
4294,NOTA,None of the Above,16660,186,16846,S0121
4295,ESWARASAMY K,Dravida Munnetra Kazhagam,530742,2635,533377,S2221
4296,KARTHIKEYAN A,All India Anna Dravida Munnetra Kazhagam,280230,1105,281335,S2221
4297,VASANTHARAJAN K,Bharatiya Janata Party,221945,1409,223354,S2221
4298,SURESHKUMAR N,Naam Tamilar Katchi,57962,234,58196,S2221
4299,PRAKASH P,Independent,2834,17,2851,S2221
4300,BENJAMINKIRUBAKARAN J,Bahujan Samaj Party,2267,17,2284,S2221
4301,VASANTHAKUMAR T,Independent,2186,4,2190,S2221
4302,RAMASAMY K,Independent,1816,9,1825,S2221
4303,ESWARASAMY K,Independent,1775,15,1790,S2221
4304,GOPALAKRISHNAN M,New Generation People’s Party,1127,6,1133,S2221
4305,KALIMUTHU S,Independent,976,5,981,S2221
4306,KARTHIKEYAN D,Independent,600,19,619,S2221
4307,NOOR MUHAMAD A,Independent,599,6,605,S2221
4308,KARTHIKEYAN P,Independent,548,19,567,S2221
4309,KARTHIKEYAN D,Independent,433,2,435,S2221
4310,NOTA,None of the Above,14399,104,14503,S2221
4311,DHARMENDRA PRADHAN,Bharatiya Janata Party,587827,4335,592162,S183
4312,PRANAB PRAKASH DAS,Biju Janata Dal,471198,1128,472326,S183
4313,NAGENDRA KUMAR PRADHAN,Indian National Congress,88573,540,89113,S183
4314,SADANAND RANBIDA,Bahujan Samaj Party,4776,19,4795,S183
4315,SRIRAM PANDEY,Independent,4700,2,4702,S183
4316,SHUSHIL KUMAR BABU,Independent,4298,5,4303,S183
4317,GNYANENDRA BEHERA,Independent,3331,3,3334,S183
4318,NABAKISHORE PRADHAN,Socialist Unity Centre Of India (COMMUNIST),3151,6,3157,S183
4319,ATMA RAM SUPKAR,Independent,2053,6,2059,S183
4320,PURUSHOTTAM PATRA,Kosal Janata Dal,1731,4,1735,S183
4321,RAKESH BAG,Bharatiya Nyay-Adhikar Raksha Party,1704,4,1708,S183
4322,SUBASH MOHAPATRA,National Jan Dal,1669,24,1693,S183
4323,LAXMAN KUMAR BHOI,Paschimanchal Vikas Party,1662,20,1682,S183
4324,KHAGESWAR BEHERA,Rashtriya Manav Party,1492,3,1495,S183
4325,NOTA,None of the Above,12451,32,12483,S183
4326,ARUN GOVIL,Bharatiya Janata Party,544375,2094,546469,S2410
4327,SUNITA VERMA,Samajwadi Party,535009,875,535884,S2410
4328,DEVVRAT KUMAR TYAGI,Bahujan Samaj Party,86693,332,87025,S2410
4329,BHUPENDRA PAL URF BHUPPI BHAI,Rashtriya Shoshit Samaj Party,2615,11,2626,S2410
4330,HAJI  AFZAL,Sabse Achchhi Party,2026,3,2029,S2410
4331,ABID HUSAIN,Social Democratic Party Of India,1917,5,1922,S2410
4332,LIYAKAT,Majloom Samaj Party,891,3,894,S2410
4333,DR HIMANSHU BHATNAGAR,Jai Hind National Party,848,6,854,S2410
4334,NOTA,None of the Above,4738,38,4776,S2410
4335,DR. PRABHA MALLIKARJUN,Indian National Congress,631453,1606,633059,S1013
4336,GAYITHRI SIDDESHWARA,Bharatiya Janata Party,604531,2434,606965,S1013
4337,G.B.VINAY KUMAR,Independent,42624,283,42907,S1013
4338,T.JABEENA AAPA,Independent,5127,1,5128,S1013
4339,D. HANUMANTHAPPA,Bahujan Samaj Party,4462,13,4475,S1013
4340,TASLIM BANU,Independent,4140,1,4141,S1013
4341,T.CHANDRU,Independent,3043,0,3043,S1013
4342,G.M.GAYITRI SIDDESHI,Independent,2453,11,2464,S1013
4343,PARAVEEJ.H,Independent,1867,2,1869,S1013
4344,ESHWARA SHENGA,Uttama Prajaakeeya Party,1424,6,1430,S1013
4345,A.K.GANESH,Independent,1054,1,1055,S1013
4346,M.C.SREENIVAS,Bharatiya Prajagala Kalyana Paksha,968,5,973,S1013
4347,SYED ZABIULLA.K,Independent,843,1,844,S1013
4348,ANABERU THIPPESWAMY,Socialist Unity Centre Of India (COMMUNIST),842,7,849,S1013
4349,SALEEM S,Independent,799,0,799,S1013
4350,MOHAMED HAYATH.M,Independent,721,1,722,S1013
4351,ABDUL NAZEER AHAMMED,Independent,651,1,652,S1013
4352,RASHEED KHAN,Independent,599,1,600,S1013
4353,M.G.SRIKANTH,Navabharath Sena,555,6,561,S1013
4354,M.P. KHALANDAR,Country Citizen Party,536,3,539,S1013
4355,PEDDAPPA S,Independent,506,2,508,S1013
4356,G.M.BARKATH ALI BASHA,Independent,470,1,471,S1013
4357,K.S. VEERBHADRAPPA,Karnataka Rashtra Samithi,466,9,475,S1013
4358,VEERESH.S (LION VEERESH),Rani Chennamma Party,457,1,458,S1013
4359,DODDESH.H.S,Janahitha Paksha,439,1,440,S1013
4360,BARKATH ALI,Independent,409,2,411,S1013
4361,MANJU. MARIKOPPA,Independent,376,2,378,S1013
4362,RUDRESHA.K.H,Samaj Vikas Kranti Party,346,2,348,S1013
4363,RAVINAIK. B,Independent,317,3,320,S1013
4364,MAHABUB BASHA,Independent,308,0,308,S1013
4365,NOTA,None of the Above,3165,11,3176,S1013
4366,SELVAGANAPATHI T M,Dravida Munnetra Kazhagam,562022,4063,566085,S2215
4367,VIGNESH P,All India Anna Dravida Munnetra Kazhagam,492958,2770,495728,S2215
4368,ANNADURAI N,Pattali Makkal Katchi,125829,1310,127139,S2215
4369,DR MANOJKUMAR G,Naam Tamilar Katchi,75636,571,76207,S2215
4370,BHALAJI M,Independent,3437,4,3441,S2215
4371,MURALI S,Bahujan Samaj Party,3333,39,3372,S2215
4372,PALANIVEL K,Independent,2853,3,2856,S2215
4373,JEGANNATHAN A,Independent,2384,27,2411,S2215
4374,RAJA S,Independent,1442,14,1456,S2215
4375,MUTHUSAMY S,Independent,1193,4,1197,S2215
4376,ER PRABAKARAN S,Independent,1151,4,1155,S2215
4377,SHANMUGAM G,Independent,1144,3,1147,S2215
4378,SANTHALINGAM C,Independent,1079,19,1098,S2215
4379,SUTHARSANAM S,Aravor Munnetra Kazhagam,1030,6,1036,S2215
4380,AMBEDKAR C,Ambedkarite Party of India,944,17,961,S2215
4381,RAMACHANDRAN C,Dhesiya Makkal Kazhagam,748,10,758,S2215
4382,GOVINDHAN A,Independent,686,7,693,S2215
4383,MANICKAM R,Ulzaipali Makkal Katchy,533,4,537,S2215
4384,AHAMED SHAHJAHAN M,Independent,453,13,466,S2215
4385,INTHRAJITHKUPTHA G,Independent,425,7,432,S2215
4386,RAMASUNDARAM D,Independent,419,3,422,S2215
4387,KARUNAKARAN M,Independent,359,18,377,S2215
4388,RAJA A,Independent,329,3,332,S2215
4389,VIGNESH M,Independent,324,4,328,S2215
4390,JOTHILINGAM M,Independent,314,2,316,S2215
4391,NOTA,None of the Above,14677,217,14894,S2215
4392,ANUPRIYA PATEL,Apna Dal (Soneylal),470866,765,471631,S2479
4393,RAMESH CHAND BIND,Samajwadi Party,433286,535,433821,S2479
4394,MANISH KUMAR,Bahujan Samaj Party,144279,167,144446,S2479
4395,RAJESH,Independent,10927,9,10936,S2479
4396,LAL JI VERMA,Independent,6355,4,6359,S2479
4397,ANIL KUMAR,Eklavya Samaj Party,6166,5,6171,S2479
4398,DAULAT SINGH,Apna Dal (Kamerawadi),5227,8,5235,S2479
4399,RAMDHANI,Rashtriya Samaj Paksha,4914,1,4915,S2479
4400,SAMEER SINGH,All India Forward Bloc,3486,1,3487,S2479
4401,SATYADEV,Purvanchal Mahapanchayat,3351,4,3355,S2479
4402,NOTA,None of the Above,15043,6,15049,S2479
4403,BIRENDRA SINGH,Samajwadi Party,472928,1548,474476,S2476
4404,DR. MAHENDRA NATH  PANDEY,Bharatiya Janata Party,451802,1109,452911,S2476
4405,SATYENDRA KUMAR MAURYA,Bahujan Samaj Party,159585,318,159903,S2476
4406,SHOBHANATH  PRAJAPATI,Bhagidari Party(P),4027,5,4032,S2476
4407,SHER SINGH,Yuga Thulasi Party,3090,6,3096,S2476
4408,SANTOSH KUMAR,Independent,2965,4,2969,S2476
4409,RAJESH VISHWAKARMA,Moulik Adhikar Party,2759,3,2762,S2476
4410,ARVIND KUMAR PATEL,Sardar Patel Siddhant Party,2734,11,2745,S2476
4411,SANJAY KUMAR SINHA,Jai Hind National Party,2617,6,2623,S2476
4412,RAM GOVIND,Samajhdar Party,1975,2,1977,S2476
4413,NOTA,None of the Above,8987,18,9005,S2476
4414,DR. KIRSAN  NAMDEO,Indian National Congress,614610,3182,617792,S1312
4415,ASHOK  MAHADEORAO NETE,Bharatiya Janata Party,474376,1720,476096,S1312
4416,GONNADE  YOGESH  NAMDEORAO,Bahujan Samaj Party,18930,125,19055,S1312
4417,HITESH PANDURANG MADAVI,Vanchit Bahujan  Aaghadi,15824,98,15922,S1312
4418,VINOD GURUDAS MADAVI,Independent,6107,19,6126,S1312
4419,KODAPE VILAS SHAMARAO,Independent,4396,6,4402,S1312
4420,SUHAS UMESH KUMRE,Bhim Sena,2851,21,2872,S1312
4421,KARAN SURESH SAYAM,Independent,2772,17,2789,S1312
4422,BARIKRAO DHARMAJI MADAVI,Bahujan Republican  Socialist Party,2527,28,2555,S1312
4423,DHIRAJ PURUSHOTTAM SHEDMAKE,Janseva Gondwana Party,2141,33,2174,S1312
4424,NOTA,None of the Above,16507,70,16577,S1312
4425,BANSURI SWARAJ,Bharatiya Janata Party,451464,1721,453185,U054
4426,SOMNATH BHARTI,Aam Aadmi Party,374032,783,374815,U054
4427,RAAJ KUMAR ANAND,Bahujan Samaj Party,5601,28,5629,U054
4428,SANJAY RAWAT,Independent,1271,5,1276,U054
4429,ACHLA JETHMALANI,Jindabad Kranti Party,1036,1,1037,U054
4430,HIRA LAL,Independent,1005,0,1005,U054
4431,PREM SINGH,Navarang Congress Party,800,6,806,U054
4432,UPEN‍DRA,Anjaan Aadmi Party,781,0,781,U054
4433,DILIP SINGH,Independent,725,1,726,U054
4434,LUKMAN KHAN,Log Party,654,2,656,U054
4435,PUNAM PANDEY,Rashtravadi Loktantrik Party (India),640,1,641,U054
4436,SANDHYA THAKKAR,Rashtriya Republican Party,485,1,486,U054
4437,RAVINDER SINGH,Independent,414,2,416,U054
4438,DINESH KUMAR,Peoples Party of India (Democratic),360,1,361,U054
4439,PRITHVI NATH SINGH,Bharatiya Sampuran Krantikari Party,335,0,335,U054
4440,MAHESH KUMAR DENWAL,Ambedkarite Party of India,287,1,288,U054
4441,MANOJ KUMAR SHARMA,Loktantrik Janshakti Party,208,4,212,U054
4442,NOTA,None of the Above,4791,22,4813,U054
4443,DILESHWAR KAMAIT,Janata Dal  (United),592922,2116,595038,S048
4444,CHANDRAHAS CHAUPAL,Rashtriya Janata Dal,422037,3198,425235,S048
4445,BAIDYA NATH MEHTA,Independent,51325,327,51652,S048
4446,YOG NARAYAN SINGH,Independent,27447,7,27454,S048
4447,VINDESHWARI PRASAD,Independent,18450,7,18457,S048
4448,KIRAN DEVI,Bahujan Samaj Party,17961,118,18079,S048
4449,MOHD KALIM KHAN,Rashtriya Jansambhavna Party,14064,14,14078,S048
4450,UMESH PRASAD SAH,Jai Hind Party,12971,43,13014,S048
4451,RAJ KUMAR YADAV,Viro Ke Vir Indian Party,10795,11,10806,S048
4452,RAMESH KUMAR ANAND,"Proutist Bloc, India",9439,12,9451,S048
4453,ABDUL MATIN,Independent,7177,17,7194,S048
4454,BAMBAM KUMAR,Independent,7000,6,7006,S048
4455,NITISH KUMAR,Independent,5894,21,5915,S048
4456,AJAY KUMAR SAH,Independent,5330,21,5351,S048
4457,SHIV HARI AGRAWAL,Bharat Nirman Party,3770,2,3772,S048
4458,NOTA,None of the Above,18444,168,18612,S048
4459,MANISH JAISWAL,Bharatiya Janata Party,647416,7197,654613,S2714
4460,JAI PRAKASH BHAI PATEL,Indian National Congress,371641,6286,377927,S2714
4461,SANJAY KUMAR MEHTA,Independent,156298,1679,157977,S2714
4462,SHASHI BHUSHAN KESHRI,Independent,15373,13,15386,S2714
4463,ANIRUDDH KUMAR,Communist Party of India,10428,40,10468,S2714
4464,MD. MOIN UDDIN AHMAD,Bahujan Samaj Party,7395,43,7438,S2714
4465,MD. SERAJ,Independent,5503,3,5506,S2714
4466,VINOD KUMAR RANA,Independent,4831,10,4841,S2714
4467,KUNJ BIHARI KUMAR,Lokhit Adhikar Party,4220,14,4234,S2714
4468,CHHATHI DEVI,Akhil Bhartiya Parivar Party,3296,20,3316,S2714
4469,ABHISHEK KUMAR,Independent,2963,9,2972,S2714
4470,NISHANT KUMAR SINHA,Peoples Party of India (Democratic),2932,24,2956,S2714
4471,MANOJ KUMAR BEDIA,Independent,2559,19,2578,S2714
4472,BHUNESHWAR BEDIYA,Samata Party,2236,28,2264,S2714
4473,RAJ KUMAR,Jharkhand Party,1885,50,1935,S2714
4474,SHYAM BIHARI PRAJAPATI,Bhagidari Party(P),1818,21,1839,S2714
4475,PRAKASH SONI,Bhartiya Azad Sena,1209,8,1217,S2714
4476,NOTA,None of the Above,7090,110,7200,S2714
4477,ANAND BHADAURIYA,Samajwadi Party,442650,1093,443743,S2429
4478,REKHA VERMA,Bharatiya Janata Party,438573,721,439294,S2429
4479,SHYAM KISHOR AWASTHI,Bahujan Samaj Party,184964,510,185474,S2429
4480,JANARDAN PRASAD,Communist Party of India,15898,2,15900,S2429
4481,RAJESH KUMAR,Political Justice Party,5020,3,5023,S2429
4482,ASHUTOSH PATHAK,Aam Janta Party (India),3550,6,3556,S2429
4483,SUDESH KUMAR,Lok Jan Sangharsh Party,2811,3,2814,S2429
4484,SAMRENDRA KUMAR,Independent,2482,2,2484,S2429
4485,VIJAY KUMAR TIWARI,Independent,2017,0,2017,S2429
4486,KASIM ALI,Peace Party,1809,3,1812,S2429
4487,SAKASEN,Sardar Patel Siddhant Party,1295,1,1296,S2429
4488,RAM NARESH,Independent,1290,0,1290,S2429
4489,NOTA,None of the Above,7133,11,7144,S2429
4490,CHANDUBHAI CHHAGANBHAI SHIHORA,Bharatiya Janata Party,664093,5656,669749,S069
4491,RUTVIKBHAI LAVJIBHAI MAKWANA,Indian National Congress,403461,4671,408132,S069
4492,DABHI ASHOKBHAI SUKHABHAI,Bahujan Samaj Party,11885,151,12036,S069
4493,VINODBHAI BABUBHAI SATROTIYA,Independent,5940,6,5946,S069
4494,KOLI RAMESHBHAI VIRSANGBHAI VAGHELA,Independent,5173,16,5189,S069
4495,CHAVDA NILESHBHAI MANSUKHBHAI,Rashtra Nirman Party,4103,26,4129,S069
4496,ZALA DEVRAJBHAI BABUBHAI,Independent,2442,21,2463,S069
4497,J.K.PATEL,Independent,2308,59,2367,S069
4498,DEVENDRA MOHANDAS MAHANT,Gunj Satya Ni Janata Party,2042,9,2051,S069
4499,GEDIYA KRUSHANAVADAN HARIPRASADBHAI,Independent,1435,24,1459,S069
4500,ANANDBHAI PACHANBHAI RATHOD,Independent,1241,8,1249,S069
4501,DILIPBHAI PARSHOTTAMBHAI MAKWANA,New India United Party,1222,35,1257,S069
4502,ASHOK PALAJIBHAI RATHOD,Independent,1087,4,1091,S069
4503,PATEL MADHUSUDAN BALDEVBHAI,Mission All India Independent Justice Party,948,12,960,S069
4504,NOTA,None of the Above,12799,500,13299,S069
4505,VENKATESAN S,Communist Party of India  (Marxist),428201,2122,430323,S2232
4506,RAAMA SREENIVASAN,Bharatiya Janata Party,219035,1879,220914,S2232
4507,SARAVANAN P,All India Anna Dravida Munnetra Kazhagam,204163,641,204804,S2232
4508,SATHYADEVI T,Naam Tamilar Katchi,92386,493,92879,S2232
4509,VELMURUGAN A,Bharatiya Praja Aikyata Party,5966,43,6009,S2232
4510,VENKATESAN M,Independent,2497,8,2505,S2232
4511,RAMAR PANDI T,Bahujan Samaj Party,2489,17,2506,S2232
4512,SHANMUGA SUNDARAM A,United Republican Party of India,2338,11,2349,S2232
4513,PERIYASAMY K,Independent,1966,2,1968,S2232
4514,PANDIYAN S,Bahujan Dravida Party,1559,3,1562,S2232
4515,BOOMINATHAN C,Independent,1211,2,1213,S2232
4516,MUTHUPANDI S,Independent,1206,1,1207,S2232
4517,RAMANATHAN S,Independent,1191,3,1194,S2232
4518,VENKATESH S,Independent,1041,5,1046,S2232
4519,SANKARAPANDI M.P.,Independent,1025,4,1029,S2232
4520,GOPISON M.M.,Independent,942,4,946,S2232
4521,SARAVANAN K.K.,Independent,843,1,844,S2232
4522,GOPALAKRISHNAN S,Independent,745,1,746,S2232
4523,CHANDRASEKAR N,Independent,708,3,711,S2232
4524,PANDIYAN P,Socialist Unity Centre Of India (COMMUNIST),576,2,578,S2232
4525,AVADAINATHAN V,Independent,461,1,462,S2232
4526,NOTA,None of the Above,11074,100,11174,S2232
4527,VIJAYAKUMAR (Alias) VIJAY VASANTH,Indian National Congress,540267,5981,546248,S2239
4528,RADHAKRISHNAN P,Bharatiya Janata Party,361623,4718,366341,S2239
4529,MARIA JENNIFER CLARA MICHAEL,Naam Tamilar Katchi,51893,828,52721,S2239
4530,PASILIAN NAZERATH,All India Anna Dravida Munnetra Kazhagam,40927,466,41393,S2239
4531,NAGOOR MEERAN PEER MOHAMED U,Independent,4412,3,4415,S2239
4532,BERRILA L,Independent,3256,6,3262,S2239
4533,BALASUBRAMANIAN T,Independent,2047,25,2072,S2239
4534,VIJAYAN G,Bahujan Samaj Party,1607,16,1623,S2239
4535,DENNISON V,Independent,1274,4,1278,S2239
4536,DR TOM MANOHAR C M,Punnagai Desam Party,1034,6,1040,S2239
4537,SATHISH BABU P,Independent,747,1,748,S2239
4538,RAJAN SINGH,Bahujan Dravida Party,592,6,598,S2239
4539,GEETA M,Thakkam Katchi,528,24,552,S2239
4540,SANTHAKUMAR N,Independent,521,6,527,S2239
4541,RAMESHKUMAR J L,Independent,464,1,465,S2239
4542,ESAKKIMUTHU N,Independent,435,6,441,S2239
4543,AYYAPPAN V,Independent,358,15,373,S2239
4544,SARAVANAN N,Samaniya Makkal Nala Katchi,308,7,315,S2239
4545,VINO JEBA SEELAN T,Independent,265,5,270,S2239
4546,KRISHNAN P,Independent,250,4,254,S2239
4547,VENKADESH S C,Independent,187,1,188,S2239
4548,ANTONY MICHAEL J,Independent,166,9,175,S2239
4549,NOTA,None of the Above,3680,76,3756,S2239
4550,INDRA HANG SUBBA,Sikkim Krantikari Morcha,156836,7560,164396,S211
4551,BHARAT BASNETT,Citizen Action Party-Sikkim,78666,4900,83566,S211
4552,PREM DAS RAI,Sikkim Democratic Front,75464,1707,77171,S211
4553,LATEN TSHERING SHERPA,Independent,20197,1066,21263,S211
4554,DINESH CHANDRA NEPAL,Bharatiya Janata Party,18788,247,19035,S211
4555,SAMBHU CHETTRI,Independent,4682,8,4690,S211
4556,KHARGA BHADUR RAI,Sikkim Republican Party,4591,208,4799,S211
4557,GOPAL CHETTRI,Indian National Congress,2190,51,2241,S211
4558,NAWIN KIRAN PRADHAN,Independent,1121,45,1166,S211
4559,RAVI CHANDRA RAI,Independent,1077,46,1123,S211
4560,BEENA RAI,Independent,1066,59,1125,S211
4561,SHYAMAL PAL,Independent,735,5,740,S211
4562,RUDRA MANI PRADHAN,Independent,512,7,519,S211
4563,MADHUKAR DHAKAL,Independent,511,21,532,S211
4564,NOTA,None of the Above,2433,94,2527,S211
4565,AMIT SHAH,Bharatiya Janata Party,999984,10988,1010972,S066
4566,SONAL RAMANBHAI PATEL,Indian National Congress,261411,4845,266256,S066
4567,MOHAMMEDANISH DESAI,Bahujan Samaj Party,7272,122,7394,S066
4568,SHAHNAWAZKHAN SULTANKHAN PATHAN,Independent,2325,7,2332,S066
4569,MALEK MAKBUL SHAKIB,Independent,2052,6,2058,S066
4570,THAKOR JITENDRASINH JASHAVANTSINH,Insaniyat Party,1949,60,2009,S066
4571,PARIKH RAJIVBHAI KALABHAI,Independent,1719,32,1751,S066
4572,MANSURI SUHANA,Independent,1437,16,1453,S066
4573,MAURYA SUMITRA DEVNARIAN,Prajatantra Aadhar Party,1205,12,1217,S066
4574,UMADIYA ALIBHAI RAJABHAI,Independent,1004,5,1009,S066
4575,RAHUL CHIMANBHAI MEHTA,Right to Recall Party,982,19,1001,S066
4576,PATHAN IMTIYAJKHAN,Independent,786,56,842,S066
4577,BAGVAN BAHADURSHAH GULMOHAMMAD,Independent,755,16,771,S066
4578,NAVSADALAM IBRAHIMBHAI MALEK,Independent,726,6,732,S066
4579,NOTA,None of the Above,21233,772,22005,S066
4580,P. P. CHAUDHARY,Bharatiya Janata Party,750568,6821,757389,S2015
4581,SANGEETA BENIWAL,Indian National Congress,505754,6284,512038,S2015
4582,LAL SINGH DEWASI,Independent,18848,154,19002,S2015
4583,HUKAM SINGH,Independent,16835,262,17097,S2015
4584,MAHENDRA REGAR,Bahujan Samaj Party,11054,47,11101,S2015
4585,JEEVARAM RANA,Bharat Adivasi Party,8325,22,8347,S2015
4586,SHRAWAN RAM DEWASI,Independent,5585,8,5593,S2015
4587,MUKESH SAINI,Independent,2471,52,2523,S2015
4588,BASTIRAM,Indian Peoples Green Party,1570,16,1586,S2015
4589,BHIYARAM,Independent,1335,10,1345,S2015
4590,ANAND KUMAR PARIHAR,Independent,1327,8,1335,S2015
4591,KESARAM,Independent,1327,18,1345,S2015
4592,DEEPAK BAMNIYA,Independent,1256,32,1288,S2015
4593,NOTA,None of the Above,13763,90,13853,S2015
4594,ANUP SANJAY DHOTRE,Bharatiya Janata Party,454972,2058,457030,S136
4595,ABHAY KASHINATH PATIL,Indian National Congress,414557,1847,416404,S136
4596,AMBEDKAR PRAKASH YASHWANT,Vanchit Bahujan  Aaghadi,275490,1257,276747,S136
4597,ADV NAJIB SHAIKH,Indian National League,3288,12,3300,S136
4598,KASHINATH VISHWANATH DHAMODE,Bahujan Samaj Party,2737,23,2760,S136
4599,MURLIDHAR LALSING PAWAR,Independent,2058,8,2066,S136
4600,ADHAU RAVIKANT RAMKRUSHNA,Jay Vidarbha Party,1710,24,1734,S136
4601,AACHARYADIP SUBHASHCHANDRA GANOJE,Independent,1610,8,1618,S136
4602,UJWALA VINAYAK RAUT,Independent,1298,8,1306,S136
4603,DHARMENDRA CHANDRAPRAKASH KOTHARI,Independent,1236,4,1240,S136
4604,DILIP SHATRUGHAN MHAISANE,Independent,860,2,862,S136
4605,ASHOK KISANRAO THORAT,Independent,573,8,581,S136
4606,MOHMMAD AJAZ MOHMMAD TAHER,Azad Adhikar Sena,564,4,568,S136
4607,BABAN MAHADEV SAYAM,Janseva Gondwana Party,535,2,537,S136
4608,PRITI PRAMOD SADANSHIV,Republican Party of India (Social),528,8,536,S136
4609,NOTA,None of the Above,5752,31,5783,S136
4610,RAHUL SINGH LODHI,Bharatiya Janata Party,708589,1179,709768,S127
4611,TARBAR SINGH LODHI (BANTU BHAIYA),Indian National Congress,302828,514,303342,S127
4612,ENGINEER GOVERDHAN RAJ,Bahujan Samaj Party,21379,25,21404,S127
4613,BHAIYA VIJAY PATEL (KURMI) TIRGARH BALE,Bhartiya Shakti Chetna Party,12200,17,12217,S127
4614,MANU SINGH MARAVI,Bharat Adivasi Party,7871,16,7887,S127
4615,RAHUL BHAIYA S/O RAM PRATAP,Independent,6273,12,6285,S127
4616,RAHUL BHAIYA S/O JEEVAN LAL,Independent,5556,5,5561,S127
4617,VEDRAM KURMI,Independent,4054,3,4057,S127
4618,RAJESH SINGH SOYAM,Gondvana Gantantra Party,3172,18,3190,S127
4619,RAKESH KUMAR AHIRWAR,Independent,2044,7,2051,S127
4620,NANDAN KUMAR AHIRWAL,Independent,1848,5,1853,S127
4621,NEELESH SONI,Independent,1277,1,1278,S127
4622,DURGA MOUSI,Independent,1120,4,1124,S127
4623,TARVAR SINGH LODHI,Independent,1092,2,1094,S127
4624,NOTA,None of the Above,7820,13,7833,S127
4625,RAJMOHAN UNNITHAN,Indian National Congress,487637,3022,490659,S111
4626,M.V BALAKRISHNAN MASTER,Communist Party of India  (Marxist),385969,4041,390010,S111
4627,M.L ASHWINI,Bharatiya Janata Party,217996,1562,219558,S111
4628,SUKUMARI M,Bahujan Samaj Party,1599,13,1612,S111
4629,RAJESWARI K.R,Independent,886,11,897,S111
4630,MANOHARAN K,Independent,777,27,804,S111
4631,ANEESH PAYYANNUR,Independent,744,15,759,S111
4632,BALAKRISHNAN N,Independent,594,34,628,S111
4633,N KESHAVA NAYAK,Independent,480,27,507,S111
4634,NOTA,None of the Above,7037,75,7112,S111
4635,KIRTIVARDHAN SINGH,Bharatiya Janata Party,473691,567,474258,S2459
4636,SHREYA VERMA,Samajwadi Party,427363,671,428034,S2459
4637,SAURABH,Bahujan Samaj Party,29388,41,29429,S2459
4638,RAM UJAGAR,Independent,3535,0,3535,S2459
4639,ARUNIMA PANDEY,Independent,3070,3,3073,S2459
4640,RAGHAVENDRA,Bhartiya Shakti Chetna Party,2027,1,2028,S2459
4641,RAJKUMAR,Independent,1988,1,1989,S2459
4642,VINOD KUMAR SINGH,Bhartiya Uday Nirman Party,1482,1,1483,S2459
4643,NOTA,None of the Above,9048,7,9055,S2459
4644,RAJ KUMAR ROAT,Bharat Adivasi Party,815430,5401,820831,S2020
4645,MAHENDRAJEETSINGH MALVIYA,Bharatiya Janata Party,568589,5188,573777,S2020
4646,RAJKUMAR S/O HIRALAL,Independent,74551,47,74598,S2020
4647,ARVIND SITA DAMOR,Indian National Congress,60917,294,61211,S2020
4648,RAJKUMAR S/O PREMJI,Independent,41742,48,41790,S2020
4649,BANSHILAL AHARI,Independent,17884,12,17896,S2020
4650,SHANKARLAL BAMANIYA,Indian Peoples Green Party,17169,19,17188,S2020
4651,DILEEP KUMAR MEENA,Bahujan Samaj Party,8573,18,8591,S2020
4652,NOTA,None of the Above,20892,78,20970,S2020
4653,MOHAMMAD JAWED,Indian National Congress,402470,380,402850,S0410
4654,MUJAHID ALAM,Janata Dal  (United),342795,363,343158,S0410
4655,AKHTARUL IMAN,All India Majlis-E-Ittehadul Muslimeen,309011,253,309264,S0410
4656,BIDESHI RISHIDEV,Independent,11815,3,11818,S0410
4657,VISHWANATH TUDU,Independent,11300,2,11302,S0410
4658,MD GUFRAN JAMALI,Independent,9992,1,9993,S0410
4659,HASIRUL,Independent,9522,2,9524,S0410
4660,BABUL ALAM,Bahujan Samaj Party,7575,4,7579,S0410
4661,RAVI KUMAR ROY,Independent,7299,3,7302,S0410
4662,SHAHABUZZAMA BHARTIYA,Rashtriya Samaj Paksha,6055,0,6055,S0410
4663,CHHOTE LAL MAHTO,Independent,3758,5,3763,S0410
4664,MOHAMMAD KAUSAR PERWEZ,Independent,3525,0,3525,S0410
4665,NOTA,None of the Above,24953,13,24966,S0410
4666,SURENDRA PRASAD YADAV,Rashtriya Janata Dal,440352,2683,443035,S0436
4667,CHANDESHWAR PRASAD,Janata Dal  (United),299044,1400,300444,S0436
4668,ARUN KUMAR,Bahujan Samaj Party,85696,684,86380,S0436
4669,MINTA DEVI,Independent,16112,11,16123,S0436
4670,MUNILAL YADAV,Independent,13021,8,13029,S0436
4671,ASHUTOSH KUMAR,Rashtriya Jan Jan Party,12954,259,13213,S0436
4672,DEEPAK KUMAR,Jagrook Janta Party,8944,26,8970,S0436
4673,BUDDHADEV SAV,Independent,5765,8,5773,S0436
4674,NARESH KUMAR,Independent,5709,3,5712,S0436
4675,CHANDESHWAR PRASAD,Independent,5356,22,5378,S0436
4676,PIYUSH SINGH,Shoshit Samaj Dal,4611,7,4618,S0436
4677,RAJ KISHOR SHARMA,Bhartiya Sarthak Party,3230,13,3243,S0436
4678,KAPIL CHAUHAN,Jan Janwadi Party,2954,10,2964,S0436
4679,ASHUTOSH VINAY KUMAR,Rashtriya Garib Dal,2895,14,2909,S0436
4680,UMA SHANKAR VERMA,Socialist Unity Centre Of India (COMMUNIST),2509,15,2524,S0436
4681,NOTA,None of the Above,10960,95,11055,S0436
4682,V K SREEKANDAN,Indian National Congress,418072,3097,421169,S118
4683,A VIJAYARAGHAVAN,Communist Party of India  (Marxist),342798,3088,345886,S118
4684,C KRISHNAKUMAR,Bharatiya Janata Party,249568,2210,251778,S118
4685,K T PADMINI,Bahujan Samaj Party,2102,30,2132,S118
4686,ANNA KURIAKOSE,Independent,1416,17,1433,S118
4687,N S K PURAM SASIKUMAR,Independent,1151,26,1177,S118
4688,RAJESH K SON OF VELANKUTTY,Independent,1033,23,1056,S118
4689,RAJESH M SON OF MANI C,Independent,947,6,953,S118
4690,SIDHEEK IRUPPASSERY,Independent,913,26,939,S118
4691,C RAJAMANICKAM,Independent,516,4,520,S118
4692,NOTA,None of the Above,8724,69,8793,S118
4693,EATALA RAJENDER,Bharatiya Janata Party,980712,10330,991042,S297
4694,PATNAM SUNEETHA MAHENDER REDDY,Indian National Congress,593337,6230,599567,S297
4695,RAGIDI LAXMA REDDY,Bharat Rashtra Samithi,298697,1789,300486,S297
4696,THALLADA VENKATESWARLU,Independent,6784,16,6800,S297
4697,ANITHA REDDY SHEELAM,Bahujan Samaj Party,4718,61,4779,S297
4698,VAISHNAVI PRASAD,Independent,1894,18,1912,S297
4699,PAREE (PESARIKAYALA PAREEKSHITH REDDY),Independent,1831,4,1835,S297
4700,DONTHULA BIKSHAPATHI,Independent,1813,8,1821,S297
4701,BHARATHA SUDARSHAN,Independent,1639,4,1643,S297
4702,APPARAO KONDA,Rashtra Samanya Praja Party,1157,5,1162,S297
4703,MOUTAM SAMPATH,Independent,1135,2,1137,S297
4704,RAJESH MISHRA,Independent,1110,0,1110,S297
4705,BANJAPALLY SUDHA RANI,Independent,1064,5,1069,S297
4706,CHIRIPI REDDY RAMESH,Independent,986,1,987,S297
4707,PEDDAPALLI SANDEEP,Bharathiya YuvaKula Dalam,930,3,933,S297
4708,BOIN DURGA PRASAD YADAV,Dharma Samaj Party,778,11,789,S297
4709,CHAMAKURA RAJAIAH ALIAS PIDIKILI RAJU,Social Justice Party of India,722,1,723,S297
4710,NARRA SUKHENDER REDDY,Vidhyarthula Rajakiya Party,690,4,694,S297
4711,KANTE SAYANNA,Independent,539,0,539,S297
4712,JUVVA PHANI KUMAR CHOWDARY,Jai Bharat National Party,505,3,508,S297
4713,YADISHWAR NAKKA,Telangana Republican Party,492,2,494,S297
4714,R. SUBENDER SINGH,Independent,446,1,447,S297
4715,NOTA,None of the Above,13206,160,13366,S297
4716,BALABHADRA MAJHI,Bharatiya Janata Party,478330,3066,481396,S1812
4717,PRADEEP KUMAR MAJHI,Biju Janata Dal,392448,1412,393860,S1812
4718,BHUJABAL MAJHI,Indian National Congress,302095,1297,303392,S1812
4719,TRINATH MUNDAGUDIA,Socialist Unity Centre Of India (COMMUNIST),20548,11,20559,S1812
4720,NOTA,None of the Above,43240,28,43268,S1812
4721,SHER SINGH GHUBAYA,Indian National Congress,264712,1914,266626,S1910
4722,JAGDEEP SINGH KAKA BRAR,Aam Aadmi Party,261273,2111,263384,S1910
4723,GURMIT SINGH SODHI,Bharatiya Janata Party,253841,1256,255097,S1910
4724,NARDEV SINGH BOBBY MANN,Shiromani Akali Dal,252327,1318,253645,S1910
4725,GURCHARAN SINGH BHULLAR,Shiromani Akali Dal (Amritsar)(Simranjit Singh Mann),15836,105,15941,S1910
4726,FOJI ANGREJ SINGH WARWAL,Independent,9435,43,9478,S1910
4727,SURINDER KAMBOJ,Bahujan Samaj Party,8347,86,8433,S1910
4728,JASKARAN SINGH KAHAN SINGH WALA,Independent,6480,55,6535,S1910
4729,SUKHDEV SINGH,Independent,4597,2,4599,S1910
4730,SAHIL MONGA,Independent,3705,19,3724,S1910
4731,PRITAM SINGH,Independent,3030,1,3031,S1910
4732,GURPREET SINGH,Independent,2894,3,2897,S1910
4733,ARWINDER SINGH,Independent,2556,14,2570,S1910
4734,DEEPAK KUMAR DEEP DASHANAND,Independent,2435,1,2436,S1910
4735,RAJ,Independent,2428,4,2432,S1910
4736,PREM CHAND BOONGI,Punjab National Party,1944,3,1947,S1910
4737,AJIT SINGH,Rashtriya Republican Party,1609,6,1615,S1910
4738,SURINDER KUMAR BANSAL,Independent,1537,3,1540,S1910
4739,HARPREET SINGH,Independent,1531,7,1538,S1910
4740,KULDEEP SINGH,India Praja Bandhu Party,1484,6,1490,S1910
4741,BALWINDER SINGH CHOHAN,Jan Sewa Driver Party,1366,1,1367,S1910
4742,BALWINDER SINGH,Republican Party of India (Athawale),1364,0,1364,S1910
4743,GURCHARAN SINGH,Independent,1338,4,1342,S1910
4744,UMESH KUMAR,Independent,1319,1,1320,S1910
4745,BALWANT SINGH SAMMEWALI,Nationalist Justice Party,1148,4,1152,S1910
4746,MOHAN SINGH,Independent,1075,3,1078,S1910
4747,JASKARAN SINGH SIDHU,Independent,970,1,971,S1910
4748,JASWANT SINGH KHATRI,Independent,820,1,821,S1910
4749,CHAMKAUR SINGH,Independent,638,4,642,S1910
4750,NOTA,None of the Above,5895,205,6100,S1910
4751,KISHORI LAL,Indian National Congress,536680,2548,539228,S2437
4752,SMRITI IRANI,Bharatiya Janata Party,370754,1278,372032,S2437
4753,NANHE SINGH CHAUHAN,Bahujan Samaj Party,34418,116,34534,S2437
4754,SURENDRA KUMAR,Independent,5699,0,5699,S2437
4755,DINESH CHANDRA MAURYA,Janshakti Samta Party,4569,8,4577,S2437
4756,JAGDAMBA PRASAD YADAV,Independent,4019,1,4020,S2437
4757,BHAGWANDIN PASI,Moulik Adhikar Party,2333,1,2334,S2437
4758,CHANDRAWATI,Independent,2278,13,2291,S2437
4759,MOHD HASAN LAHRI,Rashtriya Narayanwadi Vikas Party,1525,2,1527,S2437
4760,KHUSHIRAM,Independent,1401,0,1401,S2437
4761,UDAYRAJ,Independent,1300,5,1305,S2437
4762,SANTRAM,Samajhdar Party,1208,4,1212,S2437
4763,SHAILENDRA KUMAR MISHRA,Sanyogwadi Party,1124,4,1128,S2437
4764,NOTA,None of the Above,9371,12,9383,S2437
4765,RAJESH VERMA,Lok Janshakti Party(Ram Vilas),537331,1326,538657,S0425
4766,SANJAY KUMAR,Communist Party of India  (Marxist),375988,1538,377526,S0425
4767,RUPAM DEVI,Independent,27370,25,27395,S0425
4768,SONU KUMAR,Independent,24478,5,24483,S0425
4769,PINKESH KUMAR,Rashtriya Jan Kalyan Party Secular,19487,8,19495,S0425
4770,DR RAVI KUMAR,Bahujan Samaj Party,13894,159,14053,S0425
4771,AJAY KUMAR,Rashtriya Jansambhavna Party,8256,54,8310,S0425
4772,PRIYADARSHEE DINKAR,Independent,7892,12,7904,S0425
4773,DINANATH CHANDRAVANSHI,Independent,6142,20,6162,S0425
4774,CHANDRA KISHOR THAKUR,Aam Janta Party Rashtriya,2806,43,2849,S0425
4775,ASIF IMAM,Aadarsh Mithila Party,2434,9,2443,S0425
4776,KANCHAN MALA,Hindustan People's Party (Democratic),1478,28,1506,S0425
4777,NOTA,None of the Above,31056,55,31111,S0425
4778,SAYANI GHOSH,All India Trinamool Congress,714049,3850,717899,S2522
4779,DR. ANIRBAN GANGULY,Bharatiya Janata Party,457307,2391,459698,S2522
4780,SRIJAN BHATTACHARYYA,Communist Party of India  (Marxist),256951,1761,258712,S2522
4781,NUR ALAM KHAN,All India Secular Front,83291,71,83362,S2522
4782,RANJIT KUMAR MANDAL,Independent,13021,9,13030,S2522
4783,HOSEN GAZI,Independent,4925,2,4927,S2522
4784,SANDIP NATH,Bahujan Samaj Party,4434,28,4462,S2522
4785,KALPANA NASKAR DATTA,Socialist Unity Centre Of India (COMMUNIST),4416,35,4451,S2522
4786,BALARAM MANDAL,Independent,2829,6,2835,S2522
4787,TANUSHREE MONDAL,Independent,2419,8,2427,S2522
4788,SHANKAR MANDAL,Independent,1439,3,1442,S2522
4789,SRI GOPAN SARDAR,Mulnibasi Party of India,1366,7,1373,S2522
4790,PURNIMA DEBNATH,Independent,1301,24,1325,S2522
4791,CHANDRACHUR GOSWAMI,Independent,1112,2,1114,S2522
4792,ARUN SARKAR,Independent,1107,3,1110,S2522
4793,DIPAK SARDAR,Independent,924,3,927,S2522
4794,NOTA,None of the Above,7316,99,7415,S2522
4795,ARVIND GANPAT SAWANT,Shiv Sena (Uddhav Balasaheb Thackrey),393735,1920,395655,S1331
4796,YAMINI YASHWANT JADHAV,Shiv Sena,341291,1691,342982,S1331
4797,AFZAL S. DAWOODANI,Vanchit Bahujan  Aaghadi,5575,37,5612,S1331
4798,MOHAMMED SHUAIB BASHIR KHATEEB,Bahujan Samaj Party,4440,38,4478,S1331
4799,ARVIND NARAYAN SAWANT,Independent,3065,25,3090,S1331
4800,MOHD. NAEEM SHAIKH,Aim Political Party,1709,6,1715,S1331
4801,SABEEHA KHAN,Independent,1678,16,1694,S1331
4802,GOHIL MANISHA SHIVRAM,Independent,1032,13,1045,S1331
4803,SHANKAR SONAWANE,Independent,854,8,862,S1331
4804,RAHUL PHANASWADIKAR,Lokshahi Ekta Party,784,3,787,S1331
4805,SUBHASH RAMESH CHIPLUNKAR,Rashtriya Kisan Bahujan Party,563,4,567,S1331
4806,PRASHANT PRAKASH GHADGE,Independent,487,3,490,S1331
4807,MOHAMMED MAHTAB SHAIKH,Independent,455,3,458,S1331
4808,MATEEN AHMED RANGREJ,Independent,265,2,267,S1331
4809,NOTA,None of the Above,13290,121,13411,S1331
4810,E. TUKARAM,Indian National Congress,729581,1264,730845,S109
4811,B. SREERAMULU,Bharatiya Janata Party,629813,2040,631853,S109
4812,VALMIKI KRISHNAPPA,Bahujan Samaj Party,5901,10,5911,S109
4813,C. CHANNAVEERA,Karnataka Rashtra Samithi,3794,3,3797,S109
4814,CONDUCTOR PAMPAPATHI,Independent,2458,2,2460,S109
4815,VEERESH,Independent,1862,8,1870,S109
4816,A. DEVADAS,Socialist Unity Centre Of India (COMMUNIST),1739,2,1741,S109
4817,MANJUNATHA GOSAL,Prahar Janshakti Party,1319,3,1322,S109
4818,ARUN.S.HIREHAL,Independent,1281,1,1282,S109
4819,G. SWAMY,Navabharath Sena,940,4,944,S109
4820,NOTA,None of the Above,7871,18,7889,S109
4821,ANIL BALUNI,Bharatiya Janata Party,418531,13628,432159,S282
4822,GANESH GODIYAL,Indian National Congress,262692,5964,268656,S282
4823,SONU KUMAR,Independent,4803,19,4822,S282
4824,ASHUTOSH SINGH,Uttarakhand Kranti Dal,4182,379,4561,S282
4825,DHEER SINGH,Bahujan Samaj Party,4007,115,4122,S282
4826,MUKESH PRAKASH,Independent,3064,15,3079,S282
4827,SURESHI DEVI,Peoples Party of India (Democratic),1472,40,1512,S282
4828,DEEPENDRA SINGH NEGI,Independent,1408,232,1640,S282
4829,ARJUN SINGH,Akhil Bhartiya Parivar Party,1308,70,1378,S282
4830,RESHMA PANWAR,Socialist Unity Centre Of India (COMMUNIST),1168,125,1293,S282
4831,DR MUKESH PANT,Sainik Samaj Party,1121,58,1179,S282
4832,VINOD KUMAR SHARMA,Uttarakhand Samanta Party,838,46,884,S282
4833,SHYAMLAL,Bahujan Mukti Party,743,28,771,S282
4834,NOTA,None of the Above,11224,151,11375,S282
4835,ARVIND DHARMAPURI,Bharatiya Janata Party,588244,4074,592318,S294
4836,JEEVANREDDY THATIPARTHI,Indian National Congress,480501,2576,483077,S294
4837,GOVERDHAN BAJIREDDY,Bharat Rashtra Samithi,101929,477,102406,S294
4838,GANTA CHARITHA RAO,Independent,5707,3,5710,S294
4839,YOUGENDAR GATLA,Alliance of Democratic Reforms Party,5439,14,5453,S294
4840,KOTAGIRI SRINIVAS,Independent,5308,4,5312,S294
4841,PUPPALA LIMBADRI,Bahujan Samaj Party,4220,43,4263,S294
4842,TUTUKURU JEEVAN REDDY,Independent,4085,6,4091,S294
4843,KANDELA SUMAN,Dharma Samaj Party,3842,44,3886,S294
4844,GOLI. NARESH,Dalita Bahujana Party,3017,7,3024,S294
4845,ARE RAJENDHAR,Independent,2906,1,2907,S294
4846,KOTHAKONDA SHAKTI PRASAD,Independent,2103,3,2106,S294
4847,VEMULAA VIKRAM REDDY,Independent,2073,1,2074,S294
4848,GOPI CHENDRIAH,Independent,1721,2,1723,S294
4849,ALI MANSOOR,Anna YSR Congress Party,1454,14,1468,S294
4850,GUYYA SAIKRISHNA MURTHY,Yuga Thulasi Party,1123,6,1129,S294
4851,SYED ASGAR,Independent,1046,2,1048,S294
4852,MALAVAT VITHAL,Independent,919,0,919,S294
4853,MOGILI RAJKUMAR,India Praja Bandhu Party,825,5,830,S294
4854,RAPELLY SRINIVAS,Independent,791,2,793,S294
4855,DESHABOINA LAXMINARAYANA,Independent,723,0,723,S294
4856,ABBAGONI ASHOK GOUD,Bahujana Left Party,641,8,649,S294
4857,DEVATHI SRINIVAS,Bahujan Mukti Party,624,12,636,S294
4858,B B NAIK,Independent,581,0,581,S294
4859,BHUKYA. NANDU,Vidhyarthula Rajakiya Party,574,6,580,S294
4860,RAPALLY SATYANARAYANA,Independent,425,1,426,S294
4861,RAGI ANIL,Independent,367,8,375,S294
4862,PALAMURI SAI NIKHIL,Independent,303,4,307,S294
4863,PRASHANTH KATRAJI,Independent,284,0,284,S294
4864,NOTA,None of the Above,4440,43,4483,S294
4865,JUGAL KISHORE,Bharatiya Janata Party,677571,10017,687588,U085
4866,RAMAN BHALLA,Indian National Congress,546031,6059,552090,U085
4867,JAGDISH RAJ,Bahujan Samaj Party,10253,47,10300,U085
4868,SATISH POONCHI,Independent,5948,11,5959,U085
4869,ANKUR SHARMA,Ekam Sanatan Bharat Dal,4268,10,4278,U085
4870,NARESH KUMAR CHIB,Jammu & Kashmir National Panthers Party (Bhim),4231,12,4243,U085
4871,PRINCIPAL C D SHARMA,Independent,3256,1,3257,U085
4872,KARANJIT,Independent,3199,8,3207,U085
4873,SHABER AHMED,Independent,3174,3,3177,U085
4874,SHIKHA BANDRAL,National Awami United Party,2932,5,2937,U085
4875,DR PRINCE RAINA,Independent,2863,3,2866,U085
4876,RAJ KUMAR,Independent,2611,7,2618,U085
4877,SURINDER SINGH,Independent,2216,10,2226,U085
4878,ATUL RAINA,Independent,2063,5,2068,U085
4879,RATTAN LAL,Jammu & Kashmir People Conference,1650,1,1651,U085
4880,SWAMI DIVYA NAND,Jammu and Kashmir Nationalist People's Front,1618,2,1620,U085
4881,PERSEEN SINGH,Independent,1587,2,1589,U085
4882,NARESH KUMAR TALLA,Independent,1458,1,1459,U085
4883,GANESH CHOUDHARY,Hindustan Shakti Sena,1187,3,1190,U085
4884,VICKY KUMAR DOGRA,Independent,1163,2,1165,U085
4885,BANSI LAL,Independent,1051,8,1059,U085
4886,QARI ZAHEER ABBAS BHATTI,All India Forward Bloc,983,1,984,U085
4887,NOTA,None of the Above,4631,14,4645,U085
4888,VISHNU DAYAL RAM,Bharatiya Janata Party,762290,8072,770362,S2713
4889,MAMTA BHUIYAN,Rashtriya Janata Dal,473668,7887,481555,S2713
4890,KAMESHWAR BAITHA,Bahujan Samaj Party,39267,733,40000,S2713
4891,SANAN RAM,Lokhit Adhikar Party,17849,26,17875,S2713
4892,GANESH RAVI,Independent,17669,30,17699,S2713
4893,BRAJESH KUMAR TURI,Rashtriya Samanta Dal,17542,24,17566,S2713
4894,VRINDA RAM,Peoples Party of India (Democratic),11205,65,11270,S2713
4895,MAHENDRA BAITHA,Socialist Unity Centre Of India (COMMUNIST),5097,18,5115,S2713
4896,RAM VACHAN RAM,Bahujan Mukti Party,4924,29,4953,S2713
4897,NOTA,None of the Above,24226,117,24343,S2713
4898,ABU TAHER KHAN,All India Trinamool Congress,681674,768,682442,S2511
4899,MD SALIM,Communist Party of India  (Marxist),517733,494,518227,S2511
4900,GOURI SANKAR GHOSH,Bharatiya Janata Party,291013,1018,292031,S2511
4901,HABIB SAIKH,All India Secular Front,12359,11,12370,S2511
4902,ASIM RAY,Bhartiya Lokmat Rashtrwadi Party,5522,12,5534,S2511
4903,SAHABUDDIN MALLIK,Independent,4156,0,4156,S2511
4904,RAFIKUL ISLAM,Independent,4064,1,4065,S2511
4905,MAHAFUJUL ALAM,Socialist Unity Centre Of India (COMMUNIST),3423,3,3426,S2511
4906,MD TAIEDUL ISLAM,Social Democratic Party Of India,3291,2,3293,S2511
4907,DHANANJOY SARKAR,Independent,1535,4,1539,S2511
4908,KRISHNA PROSAD BISWAS,Independent,1197,9,1206,S2511
4909,NOTA,None of the Above,13249,21,13270,S2511
4910,SUKHDEO BHAGAT,Indian National Congress,476112,6926,483038,S2712
4911,SAMIR ORAON,Bharatiya Janata Party,339685,4215,343900,S2712
4912,CHAMRA LINDA,Independent,45082,916,45998,S2712
4913,MAHENDRA ORAON,Communist Party of India,16776,17,16793,S2712
4914,SHANIYA ORAON,Independent,10894,17,10911,S2712
4915,GIRJANANDAN URAON,Bahujan Samaj Party,9103,45,9148,S2712
4916,MARIANUS TIGGA,Independent,9100,31,9131,S2712
4917,STEPHAN KINDO,Independent,7594,5,7599,S2712
4918,BIHARI BHAGAT,Peoples Party of India (Democratic),7558,44,7602,S2712
4919,RANJEET BHAGAT,Independent,5510,17,5527,S2712
4920,RAMCHANDRA BHAGAT,Lokhit Adhikar Party,4303,7,4310,S2712
4921,PAWAN TIGGA,Independent,3685,28,3713,S2712
4922,ARPAN DEO BHAGAT,Independent,2796,18,2814,S2712
4923,ARJUN TOPPO,Independent,2706,41,2747,S2712
4924,MANI MUNDA,Bhagidari Party(P),2490,20,2510,S2712
4925,NOTA,None of the Above,11304,80,11384,S2712
4926,DEVESH CHANDRA THAKUR,Janata Dal  (United),514940,779,515719,S045
4927,ARJUN RAY,Rashtriya Janata Dal,463107,1256,464363,S045
4928,SAIQUA NAWAZ AZMAT,Independent,28911,1,28912,S045
4929,SHYAM NANDAN KISHOR PRASAD,Independent,11173,15,11188,S045
4930,BHOLA SINGH,Bahujan Samaj Party,8773,37,8810,S045
4931,UPENDRA SAHANI,Rashtriya Jansambhavna Party,8446,8,8454,S045
4932,CHANDRIKA PRASAD,Independent,7109,5,7114,S045
4933,VINOD SAH,Independent,4477,4,4481,S045
4934,KRISHNA KISHORE,Independent,3280,0,3280,S045
4935,MUSHAHID RAZA,Desh Janhit Party,2190,2,2192,S045
4936,UMESH KUMAR YADAV,Independent,2126,2,2128,S045
4937,RAJENDRA MAHTO,Karpoori Janta Dal,1976,5,1981,S045
4938,ANAND KUMAR,Independent,1787,9,1796,S045
4939,ABDUL SAMAD,Independent,1439,2,1441,S045
4940,NOTA,None of the Above,32102,31,32133,S045
4941,SARABJEET SINGH KHALSA,Independent,296922,1140,298062,S199
4942,KARAMJIT SINGH ANMOL,Aam Aadmi Party,226676,1333,228009,S199
4943,AMARJIT KAUR SAHOKE,Indian National Congress,159352,1005,160357,S199
4944,RAJWINDER SINGH DHARAMKOT,Shiromani Akali Dal,137776,475,138251,S199
4945,HANS RAJ HANS,Bharatiya Janata Party,123007,526,123533,S199
4946,GURCHARAN SINGH MANN,Communist Party of India,14935,15,14950,S199
4947,GURBAKSH SINGH CHAUHAN,Bahujan Samaj Party,8129,81,8210,S199
4948,AVTAR SINGH SAHOTA,Independent,4155,5,4160,S199
4949,KIKKAR SINGH DHALIWAL,Independent,3514,3,3517,S199
4950,KARAM SINGH MALUKA,Independent,2859,3,2862,S199
4951,RUPINDER SINGH KOHARWALA,Nationalist Justice Party,2672,5,2677,S199
4952,BALDEV SINGH GAGRA,Shiromani Akali Dal (Amritsar)(Simranjit Singh Mann),2367,28,2395,S199
4953,NIRMAL SINGH RAJEANA,Independent,2287,2,2289,S199
4954,BADAL SINGH BHALOOR,Bhartiya Rashtriya Dal,2027,1,2028,S199
4955,RAJ KUMAR CHAUHAN,Independent,1958,3,1961,S199
4956,OM PARKASH BANKA,Independent,1947,3,1950,S199
4957,CAPTAIN BAHADUR SINGH,Independent,1632,8,1640,S199
4958,MEJOR SINGH BHATTI,Jan Sewa Driver Party,1605,7,1612,S199
4959,SUKHBIR SINGH BABBAL BHATTI,Rashtriya Republican Party,1526,4,1530,S199
4960,GURMEET SINGH,Independent,1419,1,1420,S199
4961,AMRIK SINGH,Independent,1411,3,1414,S199
4962,MANPREET SHANT,Independent,1376,1,1377,S199
4963,PREM LAL,Democratic Bharatiya Samaj Party,1165,0,1165,S199
4964,PARGAT SINGH RAJEANA,Apna Samaj Party,1128,3,1131,S199
4965,JASWANT RAI RAJORA,Independent,1042,5,1047,S199
4966,DR DEV INDER GAGALANI,Republican Party of India,1035,5,1040,S199
4967,PRITAM SINGH,Bahujan Mukti Party,927,12,939,S199
4968,KULWANT KAUR,Sanjhi Virasat Party,785,1,786,S199
4969,NOTA,None of the Above,4077,66,4143,S199
4970,CHUDASAMA RAJESHBHAI NARANBHAI,Bharatiya Janata Party,578516,5533,584049,S0613
4971,JOTVA HIRABHAI ARJANBHAI,Indian National Congress,444156,4399,448555,S0613
4972,MAKADIA JAYANTILAL MALDEBHAI,Bahujan Samaj Party,7132,150,7282,S0613
4973,VADHER DANSING CHINABHAI,Independent,5161,28,5189,S0613
4974,DEVENDRABHAI DHANJIBHAI MOTIVARAS,Independent,2302,7,2309,S0613
4975,BORICHANGAR BHAVESH DALPATRAI,Independent,1884,24,1908,S0613
4976,DAKI NATHABHAI MENSIBHAI,Independent,1329,15,1344,S0613
4977,ISHWAR RAMBHAI SOLANKI,Right to Recall Party,1150,21,1171,S0613
4978,ALPESHKUMAR CHANDULAL TRAMBADIYA,Log Party,943,21,964,S0613
4979,GORDHANBHAI MANGABHAI GOHEL,Independent,758,17,775,S0613
4980,AARAB HASAM SUMRA,Independent,689,5,694,S0613
4981,NOTA,None of the Above,13434,579,14013,S0613
4982,CHANDRASHEKHAR,Aazad Samaj Party (Kanshi Ram),511812,740,512552,S245
4983,OM KUMAR,Bharatiya Janata Party,359751,1328,361079,S245
4984,MANOJ KUMAR,Samajwadi Party,102104,270,102374,S245
4985,SURENDRA PAL SINGH,Bahujan Samaj Party,13212,60,13272,S245
4986,JOGENDRA,Independent,4509,9,4518,S245
4987,SANJEEV KUMAR,Independent,2195,6,2201,S245
4988,NOTA,None of the Above,5287,20,5307,S245
4989,DR. PRADEEP KUMAR PANIGRAHY,Bharatiya Janata Party,510585,2517,513102,S1820
4990,BHRUGU BAXIPATRA,Biju Janata Dal,346780,846,347626,S1820
4991,RASMI RANJAN PATNAIK,Indian National Congress,129096,648,129744,S1820
4992,V CHANDRA SHEKHAR,Independent,8376,3,8379,S1820
4993,BHASKAR CHAUDHORY,Bahujan Samaj Party,5198,13,5211,S1820
4994,SOMANATH BEHERA,Socialist Unity Centre Of India (COMMUNIST),5121,14,5135,S1820
4995,SIRIN TAMMANA,Independent,5069,9,5078,S1820
4996,BOMMALI KANTA RAO,Naba Bharata Nirmana Seva Party,4190,11,4201,S1820
4997,RAM SANKAR SATAPATHY,Independent,3869,2,3871,S1820
4998,RAJENDRA DALABEHERA,Bharatiya Bikash Parishad,2335,8,2343,S1820
4999,SANTOSH KUMAR SAHU,All India Forward Bloc,2284,7,2291,S1820
5000,NOTA,None of the Above,15903,39,15942,S1820
5001,CHIRAG PASWAN,Lok Janshakti Party(Ram Vilas),613106,2612,615718,S0421
5002,SHIV CHANDRA RAM,Rashtriya Janata Dal,442553,3060,445613,S0421
5003,SURENDRA KUMAR PASWAN,Independent,17241,4,17245,S0421
5004,SHASHI SWARAJ,Bahujan Samaj Party,8591,88,8679,S0421
5005,HARIWANSH PASWAN,Independent,7113,4,7117,S0421
5006,SHAILENDRA KUMAR,Independent,6153,8,6161,S0421
5007,ASHOK KUMAR,Samata Party,4701,20,4721,S0421
5008,RANDHIR PASWAN,Independent,2671,4,2675,S0421
5009,RAJ KUMAR PASWAN,Yuva Bihar Sena,1983,7,1990,S0421
5010,DHARMENDRA KUMAR,Jantantra Awaj Party,1971,7,1978,S0421
5011,MADHUSUDHAN PASWAN,Independent,1793,8,1801,S0421
5012,RAJESH KUMAR RAUSHAN,Socialist Unity Centre Of India (COMMUNIST),1694,7,1701,S0421
5013,MEGHNATH PASWAN,Independent,1680,0,1680,S0421
5014,BALENDRA DAS,Janshakti Janta Dal,1308,10,1318,S0421
5015,NOTA,None of the Above,36836,91,36927,S0421
5016,N K PREMACHANDRAN,Revolutionary Socialist Party,437516,6112,443628,S1118
5017,M MUKESH,Communist Party of India  (Marxist),288861,4465,293326,S1118
5018,KRISHNAKUMAR G,Bharatiya Janata Party,160956,2254,163210,S1118
5019,VIPINLAL VIDHYADHARAN,Bahujan Samaj Party,2163,31,2194,S1118
5020,PREMACHANDRAN NAIR,Independent,1713,21,1734,S1118
5021,GOKULAM SURESH KUMAR,Independent,1369,5,1374,S1118
5022,PRADEEP KOTTARAKKARA,Bharatheeya Jawan Kisan Party,793,42,835,S1118
5023,TWINKLE PRABHAKARAN,Socialist Unity Centre Of India (COMMUNIST),689,19,708,S1118
5024,JOSE SARANATH,Ambedkarite Party of India,553,6,559,S1118
5025,BRO NOUSHAD  SHERIFF J,Independent,545,34,579,S1118
5026,P KRISHNAMMAL,Marxist Communist Party of India (United),537,12,549,S1118
5027,N JAYARAJAN,Independent,407,42,449,S1118
5028,NOTA,None of the Above,6437,109,6546,S1118
5029,KESINENI SIVANATH (CHINNI),Telugu Desam,784722,9432,794154,S0112
5030,KESINENI SRINIVAS  (NANI),Yuvajana Sramika Rythu Congress Party,505637,6432,512069,S0112
5031,BHARGAV VALLURU,Indian National Congress,23498,608,24106,S0112
5032,KRISHNA KISHORE YANAMANDRA,Navataram Party,7710,168,7878,S0112
5033,VENKATA ASHOK PAPPURI,Independent,6672,0,6672,S0112
5034,DEVARAPALLI MALLIKARJUNA RAO (MAHESH),Independent,3199,0,3199,S0112
5035,MEKA VENKATESWARA RAO,Bahujan Samaj Party,2184,49,2233,S0112
5036,ANIL KUMAR MADDINENI,Independent,1240,0,1240,S0112
5037,BARRE SREENIVASARAO (JAI BHEEM SRINIVAS),Telugu Rajadhikara Samiti Party,609,6,615,S0112
5038,SYED KHAMURUNNISA,Navarang Congress Party,600,1,601,S0112
5039,CHAGANTIPATI GANGADHAR GANDHI,Pyramid Party of India,486,3,489,S0112
5040,DATLA LURTHU MERI,Jaibhim Rao Bharat Party,409,8,417,S0112
5041,PERAM SIVA NAGESWARA RAO,Republican Party of India (Athawale),365,3,368,S0112
5042,DEVARASETTY RAVEENDRA BABU,Andhra Rastra Praja Samithi,328,3,331,S0112
5043,GUJJULA LALITHA,Socialist Unity Centre Of India (COMMUNIST),323,4,327,S0112
5044,N DASARADHA RAMI REDDY,All India Jaihind Party,268,1,269,S0112
5045,CHINTHALACHERUVU HEMALATHA,Jai Maha Bharath Party,239,5,244,S0112
5046,NOTA,None of the Above,9038,155,9193,S0112
5047,SATISH KUMAR GAUTAM,Bharatiya Janata Party,500453,1381,501834,S2415
5048,BIJENDRA SINGH,Samajwadi Party,485588,599,486187,S2415
5049,HITENDRA KUMAR ALIAS BUNTY UPADHYAY,Bahujan Samaj Party,123770,159,123929,S2415
5050,GYANI RAM,Independent,3795,4,3799,S2415
5051,SATISH KUMAR,Independent,3553,8,3561,S2415
5052,SATISH KUMAR,Swatantra Jantaraj Party,1647,1,1648,S2415
5053,MANOJ KUMAR ALIAS MANOJ LODHI,Saman Adhikar Party,1434,6,1440,S2415
5054,KESHAV DEV ALIAS PANDIT KESHAV DEV GAUTAM,Independent,1308,11,1319,S2415
5055,SURENDRA,Moulik Adhikar Party,1175,3,1178,S2415
5056,RAJESH KUMAR,Independent,1053,3,1056,S2415
5057,DILEEP SHARMA AD.,Independent,952,3,955,S2415
5058,MAHESH CHANDRA SHARMA,Independent,733,3,736,S2415
5059,RAJ KUMAR,Rashtriya Shoshit Samaj Party,407,5,412,S2415
5060,MANOJ KUMAR SHARMA ADVOCATE,Loktantrik Janshakti Party,371,7,378,S2415
5061,NOTA,None of the Above,4916,18,4934,S2415
5062,MANOHAR LAL,Bharatiya Janata Party,737282,2003,739285,S075
5063,DIVYANSHU BUDHIRAJA,Indian National Congress,504437,2271,506708,S075
5064,INDER SINGH,Bahujan Samaj Party,32410,98,32508,S075
5065,MARATHA VIRENDER VERMA,Nationalist Congress Party – Sharadchandra Pawar,28984,167,29151,S075
5066,DEVENDER KADIAN,Jannayak Janta Party,11399,68,11467,S075
5067,MANOJ BANSAL,Independent,4000,4,4004,S075
5068,GULSHAN KASHYAP,Independent,2987,7,2994,S075
5069,ASHOK KATARIA,Samst Samaj Party,2898,6,2904,S075
5070,HARJEET SINGH VIRK,Shiromani Akali Dal (Amritsar)(Simranjit Singh Mann),1857,9,1866,S075
5071,SONIA,Independent,1846,5,1851,S075
5072,MANISH,Independent,1587,0,1587,S075
5073,LEENA KOHLI,Independent,1281,11,1292,S075
5074,NITIN GEHLOT,Peoples Party of India (Democratic),1252,1,1253,S075
5075,BALWAN SINGH,Independent,1186,2,1188,S075
5076,VINEET CHOUDHARY,Bharatiya Asha Party,1018,2,1020,S075
5077,ROOP SINGH,Rashtriya Garib Dal,766,3,769,S075
5078,SAWAMI AGNIVESH,Independent,748,4,752,S075
5079,AZAD SINGH PUNIA,Independent,703,2,705,S075
5080,ASHOK KUMAR,Independent,631,2,633,S075
5081,NOTA,None of the Above,3925,30,3955,S075
5082,FAGGAN SINGH KULASTE,Bharatiya Janata Party,749761,1614,751375,S1214
5083,OMKAR SINGH MARKAM,Indian National Congress,645759,1770,647529,S1214
5084,MAHESH KUMAR WATTEE,Gondvana Gantantra Party,37686,111,37797,S1214
5085,INDAR SINGH UIKEY,Bahujan Samaj Party,16587,30,16617,S1214
5086,CHANDRA SINGH KUSHRAM,Bhartiya Shakti Chetna Party,15533,25,15558,S1214
5087,SITAR MARKAM,Independent,10365,10,10375,S1214
5088,RAKESH SINGH THAKUR,Independent,10340,6,10346,S1214
5089,DR. BHAW SINGH TEKAM,Independent,6393,8,6401,S1214
5090,CHARAN SINGH DHURWEY,Bharat Adivasi Party,4269,18,4287,S1214
5091,ADVOCATE-DEV SINGH KUMRE,Independent,4205,12,4217,S1214
5092,GHUR SINGH SALLAM,Independent,3959,12,3971,S1214
5093,KALIYA BAI KAKODIA,Independent,2990,11,3001,S1214
5094,ASHOK SARAIYA,Independent,2717,10,2727,S1214
5095,RAMKUMAR INWATI [ADVOCATE],Smart Indians Party,2499,11,2510,S1214
5096,NOTA,None of the Above,18887,34,18921,S1214
5097,MANISH TEWARI,Indian National Congress,216350,307,216657,U021
5098,SANJAY TANDON,Bharatiya Janata Party,213770,383,214153,U021
5099,RITU SINGH,Bahujan Samaj Party,6697,11,6708,U021
5100,LAKHVIR SINGH ALIAS KOTLA,Independent,2625,1,2626,U021
5101,DEEPANSHU SHARMA,Akhil Bhartiya Parivar Party,1066,2,1068,U021
5102,EX-ASSISTANT COMMANDANT RANPREET SINGH,Independent,1051,3,1054,U021
5103,VINOD KUMAR,Independent,683,0,683,U021
5104,SUNIL THAMAN,Haryana Jansena Party,576,1,577,U021
5105,BALJEET SINGH ALIAS LADDI,Independent,434,2,436,U021
5106,SUNIL KUMAR,Independent,321,0,321,U021
5107,PARTAP SINGH RANA,Independent,306,1,307,U021
5108,MAHANT RAVI KANT MUNI,Independent,295,0,295,U021
5109,VIVEK SHARMA,Independent,294,0,294,U021
5110,PIAR CHAND ALIAS KOUNDAL,Independent,253,2,255,U021
5111,KISHOR KUMAR ALIAS BANTI BHAIYA,Independent,239,0,239,U021
5112,RAJINDER KAUR,Sainik Samaj Party,215,2,217,U021
5113,RAJ PRINCE SINGH,Super Power India Party,205,0,205,U021
5114,PUSHPINDER SINGH ALIAS LOVELY ATTAWA,Independent,154,0,154,U021
5115,KULDIP RAI ALIAS HAPPY SOOD MORINDA,Independent,114,0,114,U021
5116,NOTA,None of the Above,2900,12,2912,U021
5117,ADV. DEAN KURIAKOSE,Indian National Congress,427129,5243,432372,S1113
5118,ADV. JOICE GEORGE,Communist Party of India  (Marxist),295975,2670,298645,S1113
5119,ADV. SANGEETHA VISWANATHAN,Bharath Dharma Jana Sena,90663,660,91323,S1113
5120,ADV. RUSSEL JOY,Bahujan Samaj Party,4397,40,4437,S1113
5121,JOMON JOHN,Independent,1764,55,1819,S1113
5122,SAJI @ SHAJI,Viduthalai Chiruthaigal Katchi,1493,15,1508,S1113
5123,P.K. SAJEEVAN,Independent,1025,9,1034,S1113
5124,NOTA,None of the Above,9468,51,9519,S1113
5125,DAMODAR AGARWAL,Bharatiya Janata Party,803193,4447,807640,S2023
5126,C P JOSHI,Indian National Congress,449528,3506,453034,S2023
5127,RAMESHWAR LAL BAIRWA,Bahujan Samaj Party,8243,40,8283,S2023
5128,RAJESH PATNI,Independent,8013,5,8018,S2023
5129,JAYKISHAN,Viro Ke Vir Indian Party,4061,23,4084,S2023
5130,MOTILAL SINGHANIA,Independent,3871,16,3887,S2023
5131,NARAYAN LAL JAT,Independent,1643,41,1684,S2023
5132,PAWAN KUMAR SHARMA,Right to Recall Party,1609,8,1617,S2023
5133,ANURAG AROT,Independent,1406,19,1425,S2023
5134,VIJAY KUMAR SONI,Bhartiya Garib Vikas Kalyan Party,1340,7,1347,S2023
5135,NOTA,None of the Above,13337,39,13376,S2023
5136,ANIL FIROJIYA,Bharatiya Janata Party,834374,1730,836104,S1222
5137,MAHESH PARMAR,Indian National Congress,459531,713,460244,S1222
5138,ADVOCATE PRAKASH CHOUHAN,Bahujan Samaj Party,9502,16,9518,S1222
5139,DR. HEMANT PARMAR,Bhim Sena,4973,3,4976,S1222
5140,SURESH BAGARI,Independent,2786,5,2791,S1222
5141,MAHESH PARMAR,Independent,2468,8,2476,S1222
5142,GANGA MALVIYA,Independent,1288,7,1295,S1222
5143,ANIL,Independent,979,2,981,S1222
5144,ISHWARLAL VARSHI,Independent,860,3,863,S1222
5145,NOTA,None of the Above,9310,22,9332,S1222
5146,BHARTI PARDHI,Bharatiya Janata Party,709939,2721,712660,S1215
5147,SAMRAT ASHOK SINGH SARASWAR,Indian National Congress,536333,1815,538148,S1215
5148,KANKAR MUNJARE,Bahujan Samaj Party,52883,251,53134,S1215
5149,BHUVAN SINGH KORAM,Independent,13028,46,13074,S1215
5150,NANDLAL UIKEY,Gondvana Gantantra Party,12338,84,12422,S1215
5151,D.L. MANESHWAR,Peoples Party of India (Democratic),9994,23,10017,S1215
5152,DHANENDRA DEV PAWAR BANWARI SETH,Independent,7185,60,7245,S1215
5153,MAHADEV NAGDEVE,Independent,7181,11,7192,S1215
5154,RAJKUMAR NAGESHWER,Independent,6723,5,6728,S1215
5155,MOHAN RAUT,Rashtravadi Bharat Party,3537,5,3542,S1215
5156,PRIYANKA SANJAY BHANDARKAR,Bhartiya Shakti Chetna Party,2906,20,2926,S1215
5157,ADVOCATE SATYAPRAKASH SHULKE (LODHI),Madhya Pradesh Jan Vikas Party,1929,3,1932,S1215
5158,DILEEP CHHABDA,Independent,1733,17,1750,S1215
5159,NOTA,None of the Above,11479,31,11510,S1215
5160,KANIMOZHI KARUNANIDHI,Dravida Munnetra Kazhagam,537879,2850,540729,S2236
5161,SIVASAMY VELUMANI R,All India Anna Dravida Munnetra Kazhagam,147407,584,147991,S2236
5162,VIJAYASEELAN SDR,Tamil Maanila Congress  (Moopanar),121680,700,122380,S2236
5163,ROWENA RUTH JANE J,Naam Tamilar Katchi,119374,926,120300,S2236
5164,RAJHA N P,Naam Indiar Party,6622,18,6640,S2236
5165,ARUNADEVI R,Independent,6029,43,6072,S2236
5166,CHITHIRAI JEGAN S,Independent,3637,3,3640,S2236
5167,SIVANESWARAN J,Independent,3363,13,3376,S2236
5168,SAMUEL T,Independent,2240,5,2245,S2236
5169,MANIKKARAJ A,Bahujan Samaj Party,2158,37,2195,S2236
5170,AASIRIYAR SHANMUGA SUNDARAM K,Independent,1832,7,1839,S2236
5171,KALEERMURUGAPAVENTHAN R,Makkal Nalvaazhvuk Katchi,1736,56,1792,S2236
5172,PONKUMARAN T P S,Independent,894,3,897,S2236
5173,JEYAKUMAR C,Independent,825,4,829,S2236
5174,GANDHIMALLAR S M,Independent,791,14,805,S2236
5175,BISHOP DR GODFREY NOBLE,Aanaithinthiya Jananayaka Pathukappu Kazhagam,757,12,769,S2236
5176,PERUMALKUMAR P,Puthiya Makkal Tamil Desam Katchi,727,12,739,S2236
5177,ESAKKIMUTHU V,Independent,699,11,710,S2236
5178,KANNAN G,Independent,679,10,689,S2236
5179,DAVID JEBASEELAN J,Independent,656,7,663,S2236
5180,SUDALAIMUTHU P,Independent,576,2,578,S2236
5181,KRISHNAN S,Independent,479,1,480,S2236
5182,RADHAKRISHNAN V G,Independent,456,5,461,S2236
5183,JAMES P,Independent,433,11,444,S2236
5184,PONRAJ K,Independent,428,1,429,S2236
5185,PRASANNA KUMAR M,Independent,396,0,396,S2236
5186,SELVAMUTHUKUMAR M,Independent,341,0,341,S2236
5187,SENTHIL KUMAR S,Independent,290,1,291,S2236
5188,NOTA,None of the Above,9682,124,9806,S2236
5189,BHAUSAHEB RAJARAM WAKCHAURE,Shiv Sena (Uddhav Balasaheb Thackrey),475637,1263,476900,S1338
5190,LOKHANDE SADASHIV KISAN,Shiv Sena,425498,873,426371,S1338
5191,UTKARSHA PREMANAND RUPWATE,Vanchit Bahujan  Aaghadi,90748,181,90929,S1338
5192,BHAUSAHEB RAMNATH WAKCHAURE,Independent,13973,33,14006,S1338
5193,RAMCHANDRA NAMDEV JADHAV,Bahujan Samaj Party,7000,40,7040,S1338
5194,RAVINDRA KALLAYYA SWAMY,Independent,5536,1,5537,S1338
5195,ABHIJEET ASHOKRAO POTE,Independent,4761,15,4776,S1338
5196,BHARAT SAMBHAJI BHOSLE,Samata Party,3395,8,3403,S1338
5197,SATISH BHIVA PAWAR,Independent,2765,6,2771,S1338
5198,GANGADHAR RAJARAM KADAM,Independent,2743,14,2757,S1338
5199,BAGUL GORAKSHA TANHAJI,Independent,2658,2,2660,S1338
5200,PRASHANT VASANT NIKAM,Independent,2542,3,2545,S1338
5201,ADV NITIN DADAHARI POL,Bahujan Bharat Party,2517,15,2532,S1338
5202,RAJENDRA RATNAKAR WAGHMARE,Rashtriya Jankranti Party,2500,5,2505,S1338
5203,ADV SIDHARTH DEEPAK BODHAK,Independent,2202,2,2204,S1338
5204,CHANDRAKANT SAMBHAJI DONDE,Independent,2074,6,2080,S1338
5205,ASHOK RAMCHANDRA ALHAT,Independent,1794,4,1798,S1338
5206,KHAJEKAR VIJAYRAO GOVINDRAO,Independent,1555,2,1557,S1338
5207,KHARAT NACHIKET RAGHUNATH,Independent,1146,4,1150,S1338
5208,SANJAY POPAT BHALERAO,Independent,958,5,963,S1338
5209,NOTA,None of the Above,5326,54,5380,S1338
5210,SANDHYA RAY,Bharatiya Janata Party,533462,3603,537065,S122
5211,PHOOL SINGH BARAIYA,Indian National Congress,470169,2056,472225,S122
5212,DEVASHISH JARARIYA,Bahujan Samaj Party,20322,143,20465,S122
5213,UMESH GARG,Independent,5057,15,5072,S122
5214,REKHA SHAKYA,Independent,2645,22,2667,S122
5215,HARIMOHAN,Independent,2598,12,2610,S122
5216,RAKESH,Independent,2345,24,2369,S122
5217,NOTA,None of the Above,6486,48,6534,S122
5218,RAMESH JIGAJINAGI,Bharatiya Janata Party,669055,3726,672781,S104
5219,RAJU ALAGUR.,Indian National Congress,593277,2275,595552,S104
5220,GANAPATI  RATHOD (HANJAGI),Karnataka Rashtra Samithi,7652,39,7691,S104
5221,BHOVI TARABAI,Independent,4342,11,4353,S104
5222,RAMJI YAMANAPPA BUDDHAPRIYA,Naki Bharatiya Ekta Party,2414,12,2426,S104
5223,NAGAJYOTI.B.N.,Socialist Unity Centre Of India (COMMUNIST),2375,17,2392,S104
5224,RAJAKUMAR APPANNA HONNAKATTI,Rashtriya Samaj Paksha,1784,10,1794,S104
5225,JITENDRA.ASHOK. KAMBLE,Republican Party of India (A),1605,18,1623,S104
5226,NOTA,None of the Above,7482,20,7502,S104
5227,BIPLAB KUMAR DEB,Bharatiya Janata Party,868484,12857,881341,S231
5228,ASISH KUMAR SAHA,Indian National Congress,265912,3851,269763,S231
5229,RAMENDRA REANG,Independent,8899,33,8932,S231
5230,ARUN KUMAR BHAUMIK,Socialist Unity Centre Of India (COMMUNIST),8617,167,8784,S231
5231,GOURI SANKAR NANDI,Independent,8074,40,8114,S231
5232,MILAN PADA MURASING,Independent,6625,27,6652,S231
5233,BALARAM DEBBARMA,Independent,4356,123,4479,S231
5234,BRAJALAL DEBNATH,Independent,3656,27,3683,S231
5235,ARNAB ROY,Republican Party of India (A),3420,29,3449,S231
5236,NOTA,None of the Above,14444,168,14612,S231
5237,ABHISHEK BANERJEE,All India Trinamool Congress,1043493,4737,1048230,S2521
5238,ABHIJIT DAS (BOBBY),Bharatiya Janata Party,336068,1232,337300,S2521
5239,PRATIK UR RAHAMAN,Communist Party of India  (Marxist),86507,446,86953,S2521
5240,MAJNU LASKAR,All India Secular Front,21109,30,21139,S2521
5241,SUBRATA BOSE,Independent,9819,6,9825,S2521
5242,DASARATHI PAIK,Bahujan Samaj Party,7082,29,7111,S2521
5243,MALAY GUHA ROY,Independent,2963,8,2971,S2521
5244,PULAKESH MONDAL,Independent,1945,3,1948,S2521
5245,KALIMUDDIN SK,Indian National Socialistic Action Forces,1579,11,1590,S2521
5246,RAMKUMAR MONDAL,Socialist Unity Centre Of India (COMMUNIST),1411,7,1418,S2521
5247,ANISUR RAHAMAN SK,Independent,1152,7,1159,S2521
5248,KASHINATH MONDAL,Independent,961,24,985,S2521
5249,NOTA,None of the Above,10134,54,10188,S2521
5250,NARAYAN TATU RANE,Bharatiya Janata Party,445339,3175,448514,S1346
5251,VINAYAK BHAURAO RAUT,Shiv Sena (Uddhav Balasaheb Thackrey),396524,4132,400656,S1346
5252,VINAYAK LAVU RAUT,Independent,15769,57,15826,S1346
5253,MARUTI RAMACHANDRA JOSHI,Vanchit Bahujan  Aaghadi,9873,166,10039,S1346
5254,AAYARE RAJENDRA LAHU,Bahujan Samaj Party,7796,60,7856,S1346
5255,SHAKIL SAWANT,Independent,6373,22,6395,S1346
5256,TAMBADE AMRUT ANANT (RAJAPURKAR),Independent,5563,19,5582,S1346
5257,ASHOK GANGARAM PAWAR,Bahujan Mukti Party,5244,36,5280,S1346
5258,SURESH GOVINDRAO SHINDE,Sainik Samaj Party,2209,38,2247,S1346
5259,NOTA,None of the Above,11516,127,11643,S1346
5260,KALIPADA SAREN (KHERWAL),All India Trinamool Congress,740132,3346,743478,S2533
5261,DR. PRANAT TUDU,Bharatiya Janata Party,566553,2877,569430,S2533
5262,SONAMANI TUDU,Communist Party of India  (Marxist),76850,452,77302,S2533
5263,SURYA SINGH BESRA,Jharkhand People's Party,19408,86,19494,S2533
5264,BARUN MAHATO,Independent,12029,58,12087,S2533
5265,ARUNKUMAR HANSDA,Bahujan Samaj Party,11949,40,11989,S2533
5266,SURENDRANATH SING,Independent,10781,6,10787,S2533
5267,RAMANATH ORANG,Independent,7178,10,7188,S2533
5268,BIPLAB HEMBRAM,Independent,7156,14,7170,S2533
5269,BAPI SOREN,All India Secular Front,5854,41,5895,S2533
5270,BIRSABIR BASKEY,Ambedkarite Party of India,4344,18,4362,S2533
5271,SUSHIL MANDI,Socialist Unity Centre Of India (COMMUNIST),2879,13,2892,S2533
5272,GUNADHAR SING,Independent,2818,31,2849,S2533
5273,NOTA,None of the Above,15871,49,15920,S2533
5274,PUTTA MAHESH KUMAR,Telugu Desam,737644,8707,746351,S0110
5275,KARUMURI SUNIL KUMAR,Yuvajana Sramika Rythu Congress Party,559318,5176,564494,S0110
5276,KAVURI LAVANYA,Indian National Congress,19820,1006,20826,S0110
5277,AJAY BABU BODA,Navarang Congress Party,12197,13,12210,S0110
5278,NITTA AKHILA DHARANI PAL,Bahujan Samaj Party,6664,68,6732,S0110
5279,BOKINALA KOTESWARA RAO,Independent,2253,10,2263,S0110
5280,RUDRAPAKA RATNA RAO (R.R.R),Andhra Rastra Praja Samithi,1523,3,1526,S0110
5281,KANDAVALLI JEEVA DEVA DAYAKAR,Independent,1172,8,1180,S0110
5282,AGASTEEN KOMMINA,Independent,1001,3,1004,S0110
5283,DR. MENDEM SANTHOSH KUMAR (PEDDA BABULU),Liberation Congress Party,777,9,786,S0110
5284,RAJESWARA RAO KONDRU,Bharatheeya Jawan Kisan Party,729,3,732,S0110
5285,GODUGUPATI VEERA RAGHAVULU,Pyramid Party of India,710,5,715,S0110
5286,BYRABOYINA MALYADRI,Bharatha Chaitanya Yuvajana Party,705,10,715,S0110
5287,NOTA,None of the Above,22371,144,22515,S0110
5288,VEENA DEVI,Lok Janshakti Party(Ram Vilas),566225,818,567043,S0416
5289,VIJAY KUMAR SHUKLA,Rashtriya Janata Dal,476199,1210,477409,S0416
5290,VIKKY KUMAR,Independent,34253,3,34256,S0416
5291,SHAMBHU KUMAR SINGH,Bahujan Samaj Party,21367,69,21436,S0416
5292,RAJ NARAYAN YADAV,Independent,9614,2,9616,S0416
5293,PARAMHANS SINGH,Independent,5316,1,5317,S0416
5294,HARI NARAYAN RAM,Viro Ke Vir Indian Party,5097,3,5100,S0416
5295,RAMESHWAR MAHTO,Bhartiya Sarthak Party,4141,9,4150,S0416
5296,KUMAR SHISHIR,Independent,3903,4,3907,S0416
5297,MUHAMAD AVAS,Independent,3758,0,3758,S0416
5298,ABHA RAY,Peoples Party of India (Democratic),3263,11,3274,S0416
5299,NARESH RAM,Socialist Unity Centre Of India (COMMUNIST),2998,11,3009,S0416
5300,VINOD KUMAR SHARMA,Jantantra Awaj Party,2929,5,2934,S0416
5301,ANIKET RAJ,Rashtriya Samaj Paksha,2018,7,2025,S0416
5302,BALENDRA TIWARY,Hindustan Janta Party Secular,1360,6,1366,S0416
5303,NOTA,None of the Above,27420,40,27460,S0416
5304,SAMBIT PATRA,Bharatiya Janata Party,625372,3958,629330,S1817
5305,ARUP MOHAN PATNAIK,Biju Janata Dal,523036,1585,524621,S1817
5306,JAYANARAYAN PATTANAYAK,Indian National Congress,24066,276,24342,S1817
5307,SANTANU KUMAR DAS,Bahujan Samaj Party,3918,11,3929,S1817
5308,SUBASH CHANDRA BHOI,Socialist Unity Centre Of India (COMMUNIST),3257,9,3266,S1817
5309,SOBHA PANDEY,Independent,2212,17,2229,S1817
5310,DILLIP KUMAR BARAL,Independent,1605,6,1611,S1817
5311,NOTA,None of the Above,7568,42,7610,S1817
5312,APPALANAIDU KALISETTI,Telugu Desam,729284,13829,743113,S013
5313,BELLANA CHANDRASEKHAR,Yuvajana Sramika Rythu Congress Party,487691,6071,493762,S013
5314,BOBBILI SRINU,Indian National Congress,10270,353,10623,S013
5315,PEERUBANDI PRAKASH RAO,Bahujan Samaj Party,7985,53,8038,S013
5316,VELURI VENKATA TRINADHARAO,Independent,4146,6,4152,S013
5317,ALLU SRIRAMULU,Independent,3396,5,3401,S013
5318,SIYYADULA YELLA RAO,Independent,3105,2,3107,S013
5319,SRINIVASA RAO SAMBHANA,Yuga Thulasi Party,1758,3,1761,S013
5320,MARISERLA KRISHNAMURTHY NAIDU,Independent,1617,12,1629,S013
5321,VANGAPANDU MAHESWARA RAO,Naba Bharata Nirmana Seva Party,1544,9,1553,S013
5322,CHINNAM ARUNA KUMAR,Jaibhim Rao Bharat Party,1401,10,1411,S013
5323,ATCHIYYA NAIDU SAMIREDDY,Samajwadi Party,1059,11,1070,S013
5324,ADINARAYANA TADDI,Independent,855,1,856,S013
5325,P V A ANANDA SAGAR,Independent,787,4,791,S013
5326,SAKHINETI ANANTHA RAJU,Pyramid Party of India,715,10,725,S013
5327,NOTA,None of the Above,23097,153,23250,S013
5328,DARSHAN SINGH CHOUDHARY,Bharatiya Janata Party,810529,1618,812147,S1217
5329,SANJAY SHARMA SANJU BHAIYA,Indian National Congress,379868,583,380451,S1217
5330,RAMGOVIND BARUAA,Bahujan Samaj Party,15344,43,15387,S1217
5331,PANDIT DIVYENDRA BRIJMOHAN DUBEY ADVOCATE,Bharatiya Yuva Jan Ekta Party,6157,11,6168,S1217
5332,RAKESH RAMPRASAD RICKY,Independent,5071,8,5079,S1217
5333,SARJERAO SAHARE,Independent,4487,6,4493,S1217
5334,PATRAKAR TILAK JATAV,Independent,2257,3,2260,S1217
5335,YUVRAJ GAVADE,Independent,2205,10,2215,S1217
5336,JYOTI SURESH JHARIYA,Independent,2033,13,2046,S1217
5337,MAKHAN SINGH LODHI,Bhartiya Shakti Chetna Party,1651,6,1657,S1217
5338,MUKESH YADAV,Independent,1578,10,1588,S1217
5339,PANDIT BRAJESH KHEMARIYA,Independent,1251,9,1260,S1217
5340,NOTA,None of the Above,14927,14,14941,S1217
5341,MANICKAM TAGORE B,Indian National Congress,382876,2380,385256,S2234
5342,VIJAYAPRABHAKARAN V,Desiya Murpokku Dravida Kazhagam,378243,2634,380877,S2234
5343,RADIKAA R,Bharatiya Janata Party,164149,2122,166271,S2234
5344,KAUSHIK S,Naam Tamilar Katchi,76122,909,77031,S2234
5345,RAJESH,Independent,6167,6,6173,S2234
5346,ASHOK KUMAR M,Bharatiya Praja Aikyata Party,5228,65,5293,S2234
5347,SEKAR S,Hindu Samaj Party,3436,10,3446,S2234
5348,MANIKANDAN M,Independent,3341,5,3346,S2234
5349,MAYAK KANNAN,Independent,2749,2,2751,S2234
5350,MAHENDRA RAMAKRISHNAN P,Independent,2404,1,2405,S2234
5351,SURESH,Bahujan Samaj Party,2378,19,2397,S2234
5352,SELVI K,Independent,2165,23,2188,S2234
5353,PANDIYAMMAL R,Independent,2128,5,2133,S2234
5354,SUDALAIMANI M,Independent,1357,2,1359,S2234
5355,PALANICHAMY P,Bahujan Dravida Party,1261,2,1263,S2234
5356,PALANISAMY K,Independent,1251,6,1257,S2234
5357,VENKATESWARAN V K,Independent,1242,5,1247,S2234
5358,SELVARAJAN V V,Independent,1120,1,1121,S2234
5359,MARIEESWARI M,Independent,1100,10,1110,S2234
5360,SANKARANARAYANAN N,Independent,994,4,998,S2234
5361,SELVAKUMAR M,Independent,896,6,902,S2234
5362,MUTHUKANNU C,Tamilaga Makkal Nala Katchi,753,8,761,S2234
5363,MARISELVAM S,All India People Development Party,708,3,711,S2234
5364,JEYARAJ T,Independent,602,8,610,S2234
5365,VEDHA @  DHAMODHARAN,Independent,599,1,600,S2234
5366,RAJAGOPAL S,Independent,525,2,527,S2234
5367,GANESHAMOORTHI G,Independent,457,3,460,S2234
5368,NOTA,None of the Above,9256,152,9408,S2234
5369,JUNE MALIAH,All India Trinamool Congress,699562,2630,702192,S2534
5370,AGNIMITRA PAUL,Bharatiya Janata Party,671328,3673,675001,S2534
5371,BIPLAB BHATTA,Communist Party of India,57345,440,57785,S2534
5372,ANINDITA JANA,Socialist Unity Centre Of India (COMMUNIST),9744,47,9791,S2534
5373,SANJIB DEY,Independent,8703,8,8711,S2534
5374,ANJAN (BABALU) MANDAL,Bahujan Samaj Party,6483,20,6503,S2534
5375,KAMALESH MAHATA,Independent,4229,21,4250,S2534
5376,SUKESH CHANDRA PALMAL,Independent,2757,5,2762,S2534
5377,BISWAJIT DAS,Independent,2141,3,2144,S2534
5378,NOTA,None of the Above,12362,62,12424,S2534
5379,ARUP CHAKRABORTY,All India Trinamool Congress,637465,4348,641813,S2536
5380,DR. SUBHAS SARKAR,Bharatiya Janata Party,604836,4199,609035,S2536
5381,NILANJAN DASGUPTA,Communist Party of India  (Marxist),104534,825,105359,S2536
5382,SURAJIT SINGH KURMALI,Independent,18507,62,18569,S2536
5383,GOPAL MURMU,Ambedkarite Party of India,9047,54,9101,S2536
5384,DIPA BOURI,Bahujan Samaj Party,8709,87,8796,S2536
5385,MARSHAL TUDU,Independent,6682,35,6717,S2536
5386,TARA SHANKAR GOPE,Socialist Unity Centre Of India (COMMUNIST),5490,39,5529,S2536
5387,SANDIP KUMAR DEY,Independent,4610,12,4622,S2536
5388,SAMAR KUMAR BISWAS,Kisan Mazdoor Sangharsh Party,3512,29,3541,S2536
5389,JIBAN CHAKRABORTY,Independent,3483,23,3506,S2536
5390,KARTIK CHANDRA BAURI,Independent,2741,55,2796,S2536
5391,GOUR CHANDRA HEMBRAM,Independent,2064,17,2081,S2536
5392,NOTA,None of the Above,26126,83,26209,S2536
5393,RAVINDRA SHUKLA ALIAS RAVI KISHAN,Bharatiya Janata Party,584512,1322,585834,S2464
5394,KAJAL NISHAD,Samajwadi Party,480788,1520,482308,S2464
5395,JAVED ASHRAF ALIAS JAVED SIMNANI,Bahujan Samaj Party,55660,121,55781,S2464
5396,ANAND KUMAR YADAV ALIAS ANAND KUMAR FAUJI,Bharatheeya Jawan Kisan Party,4946,9,4955,S2464
5397,PINTU SAHANI,Independent,4031,1,4032,S2464
5398,SHIVSHANKAR PRAJAPATI,Bhagidari Party(P),2631,4,2635,S2464
5399,SUDHANSHU,Independent,2393,2,2395,S2464
5400,SANJAY SINGH RANA,Bhartiya Sarvdharm Party,2011,1,2012,S2464
5401,NAFEES AKHTAR,Independent,1880,0,1880,S2464
5402,ANKIT SHAH,Bharatiya Yuva Jan Ekta Party,1871,3,1874,S2464
5403,AMITA BHARATI,Independent,1356,8,1364,S2464
5404,SONU RAI,Mera Adhikaar Rashtriya Dal,891,7,898,S2464
5405,SHRIRAM PRASAD,Al-Hind Party,762,2,764,S2464
5406,NOTA,None of the Above,7652,29,7681,S2464
5407,NABA CHARAN MAJHI,Bharatiya Janata Party,580579,5392,585971,S185
5408,SUDAM MARNDI,Biju Janata Dal,364745,1892,366637,S185
5409,ANJANI SOREN,Jharkhand Mukti Morcha,134713,686,135399,S185
5410,RABINDRA NATH SINGH,Independent,9282,42,9324,S185
5411,ASHOK KUMAR SING,Independent,8918,35,8953,S185
5412,JATIA SAWAYAN,Bahujan Samaj Party,8457,45,8502,S185
5413,SANTILATA CHATTAR,Independent,8448,29,8477,S185
5414,PITAMBAR NAIK,Socialist Unity Centre Of India (COMMUNIST),8070,44,8114,S185
5415,ANTA ALOK BASKEY,AJSU Party,5386,8,5394,S185
5416,BAJUN HANSDA,Independent,5304,18,5322,S185
5417,KANHU CHARAN TUDU,Independent,5103,35,5138,S185
5418,SUKANTA HEMBRAM,Bharatiya Nyay-Adhikar Raksha Party,3636,20,3656,S185
5419,GURU  CHARAN HEMBRAM,Bharatheeya Jawan Kisan Party,3175,35,3210,S185
5420,NOTA,None of the Above,19853,100,19953,S185
5421,PRADAN BARUAH,Bharatiya Janata Party,659307,3815,663122,S0312
5422,UDAY SHANKAR HAZARIKA,Indian National Congress,458720,3145,461865,S0312
5423,DHIREN KACHARI,Communist Party of India,19562,69,19631,S0312
5424,GHANA KANTA CHUTIA,All India Trinamool Congress,14055,142,14197,S0312
5425,BIKRAM RAMCHIARY,Independent,10218,75,10293,S0312
5426,GOBIN BISWAKARMA,Independent,7461,65,7526,S0312
5427,DEBA NATH PAIT,Independent,6143,20,6163,S0312
5428,PALLAB PEGU,Socialist Unity Centre Of India (COMMUNIST),6051,86,6137,S0312
5429,BIREN BAILUNG,Voters Party  International,5329,30,5359,S0312
5430,NOTA,None of the Above,16716,205,16921,S0312
5431,K.RADHAKRISHNAN,Communist Party of India  (Marxist),398818,4629,403447,S119
5432,RAMYA HARIDAS,Indian National Congress,379231,4105,383336,S119
5433,DR T N SARASU,Bharatiya Janata Party,186441,1789,188230,S119
5434,HARI ARUMBIL,Bahujan Samaj Party,2835,36,2871,S119
5435,KRISHNANKUTTY KUNISSERY,Independent,2323,28,2351,S119
5436,NOTA,None of the Above,11918,115,12033,S119
5437,SUDHA R,Indian National Congress,516534,1925,518459,S2228
5438,BABU P,All India Anna Dravida Munnetra Kazhagam,246083,1193,247276,S2228
5439,STALIN M K,Pattali Makkal Katchi,165770,667,166437,S2228
5440,KALIYAMMAL P,Naam Tamilar Katchi,127276,366,127642,S2228
5441,KARTHICK A,Samaniya Makkal Nala Katchi,3888,3,3891,S2228
5442,ILANCHEZHIAN T,Bahujan Samaj Party,2878,20,2898,S2228
5443,BABU S,Independent,1832,6,1838,S2228
5444,MANIMARAN T,Independent,1710,1,1711,S2228
5445,NAGARAJAN K,Independent,1342,5,1347,S2228
5446,SILAMBARASAN D,Independent,1255,1,1256,S2228
5447,JAFARULLAH KHAN F,Independent,1230,6,1236,S2228
5448,PANDIYARAJAN S,Independent,1169,5,1174,S2228
5449,TIMOTHY T,Independent,1165,10,1175,S2228
5450,VEDARETHINAM S,Anna MGR Dravida Makkal Kalgam,780,2,782,S2228
5451,NITHIYANANTHAM S,Naadaalum Makkal Katchi,735,4,739,S2228
5452,SRINIVASAN V,Independent,609,8,617,S2228
5453,DHAKSHINAMOORTHY M,Independent,518,17,535,S2228
5454,NOTA,None of the Above,8642,53,8695,S2228
5455,P V MIDHUN REDDY,Yuvajana Sramika Rythu Congress Party,639111,5733,644844,S0124
5456,NALLARI KIRAN KUMAR REDDY,Bharatiya Janata Party,557030,11743,568773,S0124
5457,SHAIK BASHEED,Indian National Congress,52229,1071,53300,S0124
5458,ABBAVARAM UGENDRA,Bahujan Samaj Party,12306,57,12363,S0124
5459,POOLA REDDY SEKHAR,Independent,6097,3,6100,S0124
5460,NAGARAJU JETTI,Independent,5984,15,5999,S0124
5461,PRADEEP PENAMADU,All India Forward Bloc,5671,1,5672,S0124
5462,CHOUDVARAM SUBBANARASAIAH,Independent,4731,4,4735,S0124
5463,PULI SREENIVASULU,Independent,4613,3,4616,S0124
5464,SREENIVASULU MARRIPATI,Independent,4436,7,4443,S0124
5465,AKBAR M BASHA,Anna YSR Congress Party,2394,17,2411,S0124
5466,SANGARAJU NAGESWARA RAJU,Independent,1523,12,1535,S0124
5467,MADA RAJA,Jaathia Chethi Vruthula Ikya Vedika Party,1415,0,1415,S0124
5468,BATTHALA RAMANAIAH,Jai Bharat National Party,1360,6,1366,S0124
5469,DODDAPANENI RAJA NAIDU,Independent,1315,3,1318,S0124
5470,MAYANA MOHAMMED SALMAN KHAN,Liberation Congress Party,1069,2,1071,S0124
5471,KASTURI OBAIAH NAIDU,Independent,885,2,887,S0124
5472,ASADI VENKATADRI,Independent,689,2,691,S0124
5473,NOTA,None of the Above,11324,76,11400,S0124
5474,ABHIJIT GANGOPADHYAY,Bharatiya Janata Party,761183,4401,765584,S2530
5475,DEBANGSHU BHATTACHARYA,All India Trinamool Congress,683955,3896,687851,S2530
5476,SAYAN BANERJEE,Communist Party of India  (Marxist),84774,615,85389,S2530
5477,MOHIUDDIN AHMED MAHI,All India Secular Front,12303,36,12339,S2530
5478,SURYANEEL DAS,Independent,6012,2,6014,S2530
5479,NARAYAN CHANDRA NAYAK,Socialist Unity Centre Of India (COMMUNIST),5633,49,5682,S2530
5480,SABITRI BISHAI,Bahujan Samaj Party,3724,30,3754,S2530
5481,DEBAPRASAD JANA,Independent,1460,7,1467,S2530
5482,KALIPADA DAS,Independent,947,27,974,S2530
5483,NOTA,None of the Above,8223,42,8265,S2530
5484,ARUN BHARTI,Lok Janshakti Party(Ram Vilas),508179,867,509046,S0440
5485,ARCHANA KUMARI,Rashtriya Janata Dal,395696,868,396564,S0440
5486,SUBHASH PASWAN,Independent,13841,34,13875,S0440
5487,SAKALDEO DAS,Bahujan Samaj Party,12313,53,12366,S0440
5488,SRAWON KUMAR,Rashtriya Jansambhavna Party,8604,21,8625,S0440
5489,JAGDISH PRASAD,Loktantrik Samajik Nyay Party,6532,10,6542,S0440
5490,SANTOSH KUMAR DAS,Socialist Unity Centre Of India (COMMUNIST),6025,8,6033,S0440
5491,NOTA,None of the Above,26148,34,26182,S0440
5492,VAMSI KRISHNA GADDAM,Indian National Congress,470180,5407,475587,S292
5493,SRINIVAS GOMASE,Bharatiya Janata Party,339107,5116,344223,S292
5494,ESHWAR KOPPULA,Bharat Rashtra Samithi,191891,1465,193356,S292
5495,ERUKULLA RAJA NARSAIAH,Bahujan Samaj Party,6730,69,6799,S292
5496,VENUGOPAL MOYYI,Bahujan Mukti Party,5220,3,5223,S292
5497,MOTHE NARESH,Peoples Party of India (Democratic),4998,9,5007,S292
5498,RAMESH MANDA,Dharma Samaj Party,4314,20,4334,S292
5499,AMBOJU SUMALATHA,Alliance of Democratic Reforms Party,3770,13,3783,S292
5500,DURGAM RAMULU,Independent,3432,2,3434,S292
5501,MULKALLA RAJENDRAPRASAD,Independent,2786,3,2789,S292
5502,RAMCHANDAR NICHHAKOLA,Dalita Bahujana Party,2589,40,2629,S292
5503,KANDI CHANDU,Rashtriya Manav Party,2409,1,2410,S292
5504,RAMULA KARTHIK,Independent,2284,4,2288,S292
5505,MOLUGU VENKATESH,New India Party,2234,35,2269,S292
5506,ERUGURALA BHAGYALAXMI,Pyramid Party of India,2113,12,2125,S292
5507,GADDAM MARUTHI,Independent,2073,8,2081,S292
5508,NAVEEN NUKALA,Independent,2057,10,2067,S292
5509,MEKALA AKSHAY KUMAR,Independent,1899,3,1902,S292
5510,KATKURI SANDEEP,Independent,1867,5,1872,S292
5511,BOTLA CHANDRAIAH,Independent,1744,3,1747,S292
5512,ERIKILLA RAJESH,Independent,1731,3,1734,S292
5513,AKKAPAKA THIRUPATHI,Independent,1662,7,1669,S292
5514,DURGAM SANTHOSH,Prajarajya Samithi,1576,38,1614,S292
5515,MAMIDIPALLY BAPAIAH,Independent,1501,3,1504,S292
5516,DUDA MAHIPAL,Independent,1495,1,1496,S292
5517,BOODIDHA THIRUPATHI,Independent,1392,1,1393,S292
5518,DAGAM SRINIVAS,Independent,1384,4,1388,S292
5519,KADASI SHEKHAR,Independent,1266,6,1272,S292
5520,DR VASARLA NATHANIAL,Independent,1195,22,1217,S292
5521,AARNAKONDA RAJU,Independent,1160,7,1167,S292
5522,NARESH JANAGAMA,Independent,1117,6,1123,S292
5523,CHILUKA ANAND,Yuva Taram Party,1089,4,1093,S292
5524,TALLAPALLY NARESH,Independent,967,1,968,S292
5525,KURMA MAHENDER,Independent,863,2,865,S292
5526,CHANDANAGIRI SHRINIVAS,Independent,766,0,766,S292
5527,KASHI SATHISH KUMAR,Anti Corruption Dynamic Party,745,6,751,S292
5528,KANAKAIAH MULKALA,Socialist Party (India),709,11,720,S292
5529,SRINIVAS PANTHUKALA,Independent,701,2,703,S292
5530,KONKATI LINGA MURTHI,Independent,659,2,661,S292
5531,JUPAKA KIRAN,Independent,649,4,653,S292
5532,RAJKUMAR DURGAM,Independent,478,1,479,S292
5533,RAJESHAM RACHARLA,Independent,422,1,423,S292
5534,NOTA,None of the Above,5591,120,5711,S292
5535,MADHAVANENI RAGHUNANDAN RAO,Bharatiya Janata Party,463777,7440,471217,S296
5536,NEELAM MADHU,Indian National Congress,427899,4179,432078,S296
5537,P. VENKATRAMA REDDY,Bharat Rashtra Samithi,395250,1540,396790,S296
5538,NANDA KISHORE TALLADA,Alliance of Democratic Reforms Party,17191,25,17216,S296
5539,SARA YADAGIRI GOUD,Praja Velugu Party,11056,4,11060,S296
5540,BODAPATLA ESHWAR,Bahujan Samaj Party,7423,40,7463,S296
5541,DUBALA SRI SAILAM,Independent,5161,5,5166,S296
5542,ADLA KUMAR,Independent,5113,3,5116,S296
5543,BANDAPALLY SRINIVAS,Socialist Unity Centre Of India (COMMUNIST),2366,0,2366,S296
5544,ANIL GOUD,Bharat Jodo Party,2128,4,2132,S296
5545,ABHILASH CHELIMELA,Independent,2031,0,2031,S296
5546,ATI ANJANEYULU,Independent,2029,9,2038,S296
5547,MAISANGARI SUNIL,India Praja Bandhu Party,2009,2,2011,S296
5548,PRADEEP,Independent,2006,4,2010,S296
5549,INDRAGOUD SILIVERI,National Nava Kranthi Party,1773,1,1774,S296
5550,NAGAMANI ACHA,Independent,1538,2,1540,S296
5551,A. KRANTHI KUMAR,Independent,1465,2,1467,S296
5552,MAREPALLY LAXMINARAYANA,Independent,1411,3,1414,S296
5553,BALESH UPPARI,Independent,1390,3,1393,S296
5554,VENKATESH BEJUGAM,Independent,1263,1,1264,S296
5555,BOMMALA VIJAY KUMAR,Independent,1194,2,1196,S296
5556,ANNELA LAXMAN,Dharma Samaj Party,1143,9,1152,S296
5557,ABHILASH SHIRNA,Independent,923,1,924,S296
5558,DODLA VENKAT,Telangana Praja Shakthi Party,915,2,917,S296
5559,ABISHEK GOUD THABETI,Jana Shankhaaraavam Party,792,5,797,S296
5560,MEDI SRINIVAS REDDI,Independent,791,2,793,S296
5561,VUTLA RAMESH,Independent,778,0,778,S296
5562,D. NARAHARI,Independent,674,1,675,S296
5563,GOLLAPALLY SAYA GOUD,Pyramid Party of India,656,2,658,S296
5564,SATYANARAYANA GOUD KOVURI,Independent,607,0,607,S296
5565,DASARI BHANUCHANDER,Independent,573,2,575,S296
5566,DADIGE RAJENDAR,Independent,556,3,559,S296
5567,C.H. NAVEEN KUMAR,Independent,529,2,531,S296
5568,KONDI ASHOK,Independent,509,0,509,S296
5569,URELLI YELLAIAH,Viduthalai Chiruthaigal Katchi,492,2,494,S296
5570,GONDHI BHUJANGAMU,Independent,430,1,431,S296
5571,MOHD AZHER,Independent,414,2,416,S296
5572,S RAJESH SAGAR,Independent,348,0,348,S296
5573,KASOJU SRIKANTH,Independent,344,0,344,S296
5574,K. LAXMINARAYANA,Independent,317,0,317,S296
5575,KOLKUR PRATAP,Independent,292,1,293,S296
5576,GADILA ANJANEYULU,Independent,289,1,290,S296
5577,GOUTI MALLESH,Independent,247,1,248,S296
5578,K.RAGHU,Independent,222,2,224,S296
5579,NOTA,None of the Above,4582,35,4617,S296
5580,TRIVENDRA SINGH RAWAT,Bharatiya Janata Party,648498,5310,653808,S285
5581,VIRENDRA RAWAT,Indian National Congress,487406,2346,489752,S285
5582,UMESH KUMAR PATRAKAR,Independent,89958,1230,91188,S285
5583,JAMIL AHMAD,Bahujan Samaj Party,42116,207,42323,S285
5584,BALBIR SINGH BHANDARI,Uttarakhand Samanta Party,2943,18,2961,S285
5585,MOHAN SINGH ASWAL,Uttarakhand Kranti Dal,2809,45,2854,S285
5586,VIJAY KUMAR,Independent,2409,1,2410,S285
5587,PAWAN KASHYAP,Independent,2170,8,2178,S285
5588,KARAN SINGH SAINI ENGINEER,Independent,1963,11,1974,S285
5589,AKRAM HUSSAIN,Independent,1678,7,1685,S285
5590,LALIT KUMAR,Peoples Party of India (Democratic),1396,14,1410,S285
5591,SURESH PAL,Bhartiya Rashtriya Ekta Dal,1150,12,1162,S285
5592,ASHISH DHYANI,Independent,1107,10,1117,S285
5593,AVNISH KUMAR,Independent,967,8,975,S285
5594,NOTA,None of the Above,6663,163,6826,S285
5595,KAMALJEET SEHRAWAT,Bharatiya Janata Party,838332,4326,842658,U056
5596,MAHABAL MISHRA,Aam Aadmi Party,641759,1886,643645,U056
5597,VISHAKHA,Bahujan Samaj Party,7899,65,7964,U056
5598,SABIR KHAN,Independent,3096,1,3097,U056
5599,AJ RAJAN,Navarang Congress Party,2381,6,2387,U056
5600,SUNIL MEGHWAL,Ambedkarite Party of India,1874,2,1876,U056
5601,OM PRAKASH NARAYAN,Aapki Apni Party (Peoples),1770,3,1773,U056
5602,ANJU SHARMA,Independent,1263,4,1267,U056
5603,KAPIL MARWAH,Independent,1154,1,1155,U056
5604,JARNAIL SINGH,Independent,1083,6,1089,U056
5605,MADHU,Akhil Bhartiya Parivar Party,1056,3,1059,U056
5606,RAJIV KANT MISHRA,Independent,995,0,995,U056
5607,RAMESH KUMAR JAIN @ NIRBHIK,Gareeb Aadmi Party,971,0,971,U056
5608,UMA SHANKAR TIWARI,Bhartiya Mahasangh Party,753,5,758,U056
5609,MEENA UJJAINWAL,Peoples Party of India (Democratic),752,4,756,U056
5610,CHARANJEET SINGH,All India Forward Bloc,614,5,619,U056
5611,UMESH CHAUHAN,Rashtriya Rashtrawadi Party,611,3,614,U056
5612,PRAMOD KUREEL,Bahujan National Party (Ambedkar),585,1,586,U056
5613,AMIT KUMAR SINGH,Rashtriya Suraksha Party,571,3,574,U056
5614,JAYA RAMAN,Sarvlokhit Samaj Party,439,7,446,U056
5615,RAM NARAYAN MOHANTY,Independent,433,1,434,U056
5616,CHAMAN LAL VERMA,Samaj Vikas Kranti Party,418,2,420,U056
5617,DEEPAK SHARMA,Bharatiya Jan Jagriti Party,362,8,370,U056
5618,RAVI,Independent,280,2,282,U056
5619,NOTA,None of the Above,8624,75,8699,U056
5620,B.Y.RAGHAVENDRA,Bharatiya Janata Party,775731,2990,778721,S1014
5621,GEETHA SHIVARAJKUMAR,Indian National Congress,533622,1384,535006,S1014
5622,K. S. ESHWARAPPA,Independent,29959,91,30050,S1014
5623,BANDI,Independent,7265,1,7266,S1014
5624,RAVIKUMARA N.,Independent,4551,1,4552,S1014
5625,POOJA N. ANNAIAH,Independent,3454,3,3457,S1014
5626,A.D. SHIVAPPA,Bahujan Samaj Party,2772,7,2779,S1014
5627,N. V. NAVEEN KUMAR,Independent,1992,1,1993,S1014
5628,ARUNA KANAHALLI,Uttama Prajaakeeya Party,1475,3,1478,S1014
5629,E.H. NAYAK,Independent,953,1,954,S1014
5630,JOHN BENNY,Independent,863,4,867,S1014
5631,GANESH. B (BELLI),Independent,736,11,747,S1014
5632,D.S. ESHWARAPPA,Independent,687,8,695,S1014
5633,KUNAJE MANJUNATHA GOWDA,Independent,671,12,683,S1014
5634,S.K PRABHU,Karnataka Rashtra Samithi,611,6,617,S1014
5635,SHIVARUDRAIAH SWAMY,Independent,599,0,599,S1014
5636,IMTIYAZ A. ATTAR,Independent,440,2,442,S1014
5637,MOHAMMED YUSUF KHAN,Young Star Empowerment Party,403,1,404,S1014
5638,G. JAYADEVA,Independent,367,1,368,S1014
5639,CHANDRASHEKAR. H C,Independent,352,5,357,S1014
5640,P. SRIPATHI. BHAT,Independent,343,1,344,S1014
5641,SANDESH SHETTY. A,Independent,292,1,293,S1014
5642,H SURESH POOJARI,Independent,219,1,220,S1014
5643,NOTA,None of the Above,4311,21,4332,S1014
5644,ARUN KUMAR SAGAR,Bharatiya Janata Party,591500,1218,592718,S2427
5645,JYOTSNA GOND,Samajwadi Party,534720,2619,537339,S2427
5646,DOD RAM VERMA,Bahujan Samaj Party,91302,408,91710,S2427
5647,KIRAN,Rashtriya Sanatan Party,6587,1,6588,S2427
5648,SHIV KUMAR,Independent,2805,0,2805,S2427
5649,MEENA KASYAP,Independent,2051,10,2061,S2427
5650,PRADEEP KUMAR,Independent,1996,9,2005,S2427
5651,PREMCHANDRA HARIJAN,Sardar Patel Siddhant Party,1686,1,1687,S2427
5652,DHARM PAL,Independent,1413,10,1423,S2427
5653,RAMESH CHANDRA VERMA,Manav Kranti Party,1076,0,1076,S2427
5654,NOTA,None of the Above,8449,41,8490,S2427
5655,PRASUN BANERJEE,All India Trinamool Congress,625229,1264,626493,S2525
5656,DR RATHIN CHAKRAVARTY,Bharatiya Janata Party,455996,1055,457051,S2525
5657,SABYASACHI CHATTERJEE,Communist Party of India  (Marxist),151483,522,152005,S2525
5658,PALASH BACHAR,Bahujan Samaj Party,6342,12,6354,S2525
5659,SEIKH SAKIRUL ISLAM,Independent,5271,0,5271,S2525
5660,SHIWA MALLICK,Independent,3218,2,3220,S2525
5661,UTTAM CHATTERJEE,Socialist Unity Centre Of India (COMMUNIST),2319,6,2325,S2525
5662,SHAMPA DAS,Bharatiya Nyay-Adhikar Raksha Party,2053,12,2065,S2525
5663,RATHIN GANGULY,Independent,1884,3,1887,S2525
5664,PRASUN LAHIRI,Independent,1323,3,1326,S2525
5665,RAJESH KUMAR PRASAD,All India Arya Mahasabha,1268,4,1272,S2525
5666,ADARSHA MONDAL,Independent,939,6,945,S2525
5667,AJAZ AHMED ANSARI,Independent,856,1,857,S2525
5668,TAPAS BARUI,Independent,637,4,641,S2525
5669,NOTA,None of the Above,10036,48,10084,S2525
5670,K. SUDHAKARAN,Indian National Congress,512266,6258,518524,S112
5671,M.V. JAYARAJAN,Communist Party of India  (Marxist),402614,6928,409542,S112
5672,C. RAGHUNATH,Bharatiya Janata Party,118352,1524,119876,S112
5673,RAMACHANDRAN BAVILEERI,Bharatheeya Jawan Kisan Party,2606,43,2649,S112
5674,K. SUDHAKARAN S/O. KRISHNAN,Independent,990,19,1009,S112
5675,SUDHAKARAN. K S/O. P GOPALAN,Independent,893,3,896,S112
5676,JOY JOHN PATTAR MADATHIL,Independent,616,2,618,S112
5677,JAYARAJ,Independent,478,10,488,S112
5678,JAYARAJAN S/O. VELAYUDHAN,Independent,421,4,425,S112
5679,VADI HAREENDRAN,Independent,289,54,343,S112
5680,C. BALAKRISHNAN YADAV,Independent,279,25,304,S112
5681,NARAYANA KUMAR,Independent,263,45,308,S112
5682,NOTA,None of the Above,8718,155,8873,S112
5683,DAGGUBATI PURANDHESHWARI,Bharatiya Janata Party,718641,7874,726515,S018
5684,DR. GUDURI SRINIVAS,Yuvajana Sramika Rythu Congress Party,483172,4204,487376,S018
5685,GIDUGU RUDRARAJU,Indian National Congress,31441,1067,32508,S018
5686,GANESWARA RAO PARAMATA,Bahujan Samaj Party,20277,132,20409,S018
5687,BATTULA BALARAMAKRISHNA,Navarang Congress Party,16930,78,17008,S018
5688,SALOPANTULA RAGHAVENDRA RAO,Independent,3261,17,3278,S018
5689,DR. MEDISI RATNARAO ALIAS VINAY,Independent,3109,6,3115,S018
5690,MOHANARAO SINGULURI,Jai Bharat National Party,2818,15,2833,S018
5691,MEDA SRINIVASA RAO,Rashtriya Praja Congress  (Secular),2422,7,2429,S018
5692,BOMMANABOINA VSR MURTHY,Independent,2173,6,2179,S018
5693,BHANU CHANDAR KURUVELLA,Independent,1955,3,1958,S018
5694,JALLI BALA NAVEENA,Independent,1250,4,1254,S018
5695,NOTA,None of the Above,24302,133,24435,S018
5696,V. SOMANNA,Bharatiya Janata Party,716709,4237,720946,S1019
5697,S.P. MUDDAHANUMEGOWDA,Indian National Congress,543064,2288,545352,S1019
5698,J.K. SAMI,Independent,6761,14,6775,S1019
5699,RAJASIMHA J. N.,Bahujan Samaj Party,5521,33,5554,S1019
5700,S.N. SWAMY,Socialist Unity Centre Of India (COMMUNIST),4582,9,4591,S1019
5701,RANGANATHA. R.S,Independent,3129,3,3132,S1019
5702,MALLIKARJUNAIAH,Independent,1872,8,1880,S1019
5703,SIDDARAMEGOWDA T. B,Independent,1644,2,1646,S1019
5704,PRADEEP KUMAR DODDAMUDDEGOWDA,Karnataka Rashtra Samithi,1606,12,1618,S1019
5705,H.L. MOHAN KUMAR,Independent,890,3,893,S1019
5706,PRAKASH. R.A. JAIN,Independent,859,4,863,S1019
5707,NEELAKANTESHA. H S,Independent,710,9,719,S1019
5708,R. PUSHPA,Independent,622,7,629,S1019
5709,B. DEVARAJ,Independent,491,8,499,S1019
5710,R. NARAYANAPPA,Independent,483,24,507,S1019
5711,DR. H.B.M. HIREMATH,Kannada  Paksha,477,0,477,S1019
5712,KAPANIGOWDA.,Independent,451,20,471,S1019
5713,BASAVARAJU. H.R,National Maha Sabha Party,433,6,439,S1019
5714,NOTA,None of the Above,6426,34,6460,S1019
5715,BHASKAR MURLIDHAR BHAGARE,Nationalist Congress Party – Sharadchandra Pawar,575291,2048,577339,S1320
5716,DR. BHARATI PRAVIN PAWAR,Bharatiya Janata Party,462333,1807,464140,S1320
5717,BABU SADU BHAGRE (SIR),Independent,103526,106,103632,S1320
5718,DHOMSE MALATI RAHUL,Vanchit Bahujan  Aaghadi,37006,97,37103,S1320
5719,JAGTAP DIPAK GANPAT,Independent,15664,17,15681,S1320
5720,TULSHIRAM CHIMAN KHOTARE,Bahujan Samaj Party,9589,65,9654,S1320
5721,KISHOR AMBADAS DAGALE,Ambedkarite Party of India,8032,23,8055,S1320
5722,ANIL GAWALIRAM BARDE,Independent,6432,9,6441,S1320
5723,BHARAT ARUN PAWAR,Bahujan Republican  Socialist Party,5613,8,5621,S1320
5724,GULAB MOHAN BARDE,Prabuddha Republican Party,4983,15,4998,S1320
5725,NOTA,None of the Above,8206,40,8246,S1320
5726,RAJIV RANJAN SINGH ALIAS LALAN SINGH,Janata Dal  (United),547814,2332,550146,S0428
5727,KUMARI ANITA,Rashtriya Janata Dal,467412,1864,469276,S0428
5728,SHANKAR PRASAD BIND,Independent,21016,7,21023,S0428
5729,PRIYADARSHI PIYUSH,Independent,15718,13,15731,S0428
5730,A. K. SINGH ‘ASHOK’,Independent,13809,16,13825,S0428
5731,KUMAR NAVNEET HIMANSHU,Bahujan Samaj Party,12143,137,12280,S0428
5732,KULDIP YADAV,Hindustan People's Party (Democratic),9455,31,9486,S0428
5733,NEETISH KUMAR,Independent,7470,37,7507,S0428
5734,PRAVAL KUMAR,Independent,5366,9,5375,S0428
5735,RAVINDRA MANDAL,Socialist Unity Centre Of India (COMMUNIST),4893,20,4913,S0428
5736,ADITYA SINGH MADHUKAR,Independent,4124,16,4140,S0428
5737,PANKAJ KUMAR,Independent,3410,18,3428,S0428
5738,NOTA,None of the Above,21920,31,21951,S0428
5739,BIBHU PRASAD TARAI,Bharatiya Janata Party,585672,3421,589093,S1816
5740,DR. RAJASHREE MALLICK,Biju Janata Dal,546443,1954,548397,S1816
5741,RABINDRA KUMAR SETHY,Indian National Congress,122875,695,123570,S1816
5742,RAMESH CHANDRA SETHY,Communist Party of India,8112,18,8130,S1816
5743,PEEYUUSH DAS,Ambedkarite Party of India,3225,5,3230,S1816
5744,BIBHUTI BHUSAN MAJHI,Bahujan Samaj Party,2718,22,2740,S1816
5745,MAHESWAR DAS,Socialist Unity Centre Of India (COMMUNIST),2374,10,2384,S1816
5746,SANKAR DAS,Independent,1476,12,1488,S1816
5747,SILI MALLICK,Samruddha Odisha,924,6,930,S1816
5748,ARJUNA CHARAN BEHERA,Independent,758,8,766,S1816
5749,BHANUMATI DAS,Utkal Samaj,674,3,677,S1816
5750,NOTA,None of the Above,4852,30,4882,S1816
5751,PUSHPENDRA SAROJ,Samajwadi Party,509175,612,509787,S2450
5752,VINOD KUMAR SONKAR,Bharatiya Janata Party,405142,701,405843,S2450
5753,SHUBH NARAYAN,Bahujan Samaj Party,55797,61,55858,S2450
5754,PUSHPENDRA KUMAR SAROJ,Independent,5178,6,5184,S2450
5755,NARENDRA KUMAR,Apna Dal (Kamerawadi),5127,4,5131,S2450
5756,SANJAY KUMAR,Independent,4631,3,4634,S2450
5757,RAJENDRA SONKAR URF PANNA BHAIYA,Independent,3421,0,3421,S2450
5758,PRADEEP KUMAR,Independent,2539,2,2541,S2450
5759,RAMESHWAR PRASAD,Bhartiya Shakti Chetna Party,2011,2,2013,S2450
5760,RAM ASREY,Manavtawadi Samaj Party,1948,2,1950,S2450
5761,NOTA,None of the Above,12958,9,12967,S2450
5762,LALJI VERMA,Samajwadi Party,543721,1238,544959,S2455
5763,RITESH PANDEY,Bharatiya Janata Party,406851,861,407712,S2455
5764,QAMAR HAYAT,Bahujan Samaj Party,199252,247,199499,S2455
5765,NEELAM SINGH,Moolniwasi Samaj Party,4321,10,4331,S2455
5766,SHABANA KHATOON,Peace Party,3983,7,3990,S2455
5767,JAVED AHMAD SIDDIQUI,Independent,3857,3,3860,S2455
5768,RAM NARESH PRAJAPATI,Bhagidari Party(P),3410,3,3413,S2455
5769,VIVEK KUMAR,Bhartiya Shakti Chetna Party,1848,2,1850,S2455
5770,NOTA,None of the Above,7429,19,7448,S2455
5771,SARMISTHA SETHI,Biju Janata Dal,529428,3224,532652,S188
5772,RABINDRA NARAYAN BEHERA,Bharatiya Janata Party,528959,5280,534239,S188
5773,ANCHAL DAS,Indian National Congress,52455,690,53145,S188
5774,SUBASH CHANDRA MALLIK,Socialist Unity Centre Of India (COMMUNIST),17955,52,18007,S188
5775,ER. SANDHYA RANI MALLICK,Bahujan Samaj Party,3189,29,3218,S188
5776,BHAIRABA PRASAD BEHERA,Independent,2398,5,2403,S188
5777,SUMANTA MALIK,Independent,2295,6,2301,S188
5778,BIDYADHAR DALEI,Ambedkarite Party of India,2172,0,2172,S188
5779,JHUNA MALIK,Manas Lokshakti Dal,2075,2,2077,S188
5780,ARTTATRANA MALIK,Independent,1234,18,1252,S188
5781,NARENDRA MALIKA,Independent,1119,0,1119,S188
5782,MANTU SETHI,Janta Darbar Party,954,2,956,S188
5783,BINOD KUMAR JENA,Gana Suraksha Party,876,3,879,S188
5784,NOTA,None of the Above,6738,50,6788,S188
5785,NEERAJ MAURYA,Samajwadi Party,491119,1396,492515,S2424
5786,DHARMENDRA KASHYAP,Bharatiya Janata Party,475434,1112,476546,S2424
5787,ABID ALI,Bahujan Samaj Party,95407,223,95630,S2424
5788,KAUSAR KHAN,Peace Party,4210,3,4213,S2424
5789,PREM PAL SAGAR,Vanchitsamaj Insaaf Party,3328,2,3330,S2424
5790,MAKKHAN LAL,Independent,2946,7,2953,S2424
5791,RAJ KUMAR PATEL,Sardar Patel Siddhant Party,2700,6,2706,S2424
5792,MOHAMMAD AMIR KHAN,Bharat Jodo Party,2348,7,2355,S2424
5793,NIRMOD KUMAR SINGH,Bhartiya Shakti Chetna Party,1785,5,1790,S2424
5794,NOTA,None of the Above,6843,15,6858,S2424
5795,ADHIKARI SOUMENDU,Bharatiya Janata Party,757906,5289,763195,S2531
5796,UTTAM BARIK SON OF LATE BIRENDRA BARIK,All India Trinamool Congress,709763,5668,715431,S2531
5797,URBASI BANERJEE,Indian National Congress,30737,385,31122,S2531
5798,BIDESH BASU MAITY,Independent,5633,21,5654,S2531
5799,MANAS PRADHAN,Socialist Unity Centre Of India (COMMUNIST),2489,40,2529,S2531
5800,UTTAM BARIK SON OF LATE NARAYAN BARIK,Independent,1963,35,1998,S2531
5801,MAKHAN LAL MAHAPATRA,Bahujan Samaj Party,1792,12,1804,S2531
5802,MD AHAMADULLAH KHAN,Independent,530,56,586,S2531
5803,ARJUN KUMAR MAITY,Independent,504,40,544,S2531
5804,NOTA,None of the Above,8075,59,8134,S2531
5805,Suresh Kumar Kashyap,Bharatiya Janata Party,513936,5812,519748,S084
5806,Vinod Sultanpuri,Indian National Congress,423388,4909,428297,S084
5807,Anil Kumar Manget,Bahujan Samaj Party,6379,121,6500,S084
5808,Suresh Kumar,Rashtriya Devbhumi Party,4766,48,4814,S084
5809,Madan Lal,Akhil Bhartiya Parivar Party,4633,43,4676,S084
5810,NOTA,None of the Above,5876,54,5930,S084
5811,JAI PARKASH (J P) S/O HARIKESH,Indian National Congress,567194,3230,570424,S074
5812,RANJIT SINGH,Bharatiya Janata Party,504944,2099,507043,S074
5813,DESH RAJ,Bahujan Samaj Party,25892,123,26015,S074
5814,SUNAINA CHAUTALA,Indian National Lok Dal,22171,132,22303,S074
5815,NAINA SINGH CHAUTALA,Jannayak Janta Party,21910,122,22032,S074
5816,PARDEEP DAHIYA,Independent,3607,1,3608,S074
5817,JAI PRAKASH (J.P.) S/O UMA DUTT,Independent,3267,6,3273,S074
5818,JILE SINGH,Independent,3196,0,3196,S074
5819,POONAM MOR,Independent,1237,4,1241,S074
5820,ISHWAR JHAJHRIA,Independent,1121,1,1122,S074
5821,ATMA RAM BISHNOI,Independent,1091,6,1097,S074
5822,KULBIR,Independent,1041,0,1041,S074
5823,CHANDER MOHAN,Independent,995,3,998,S074
5824,ADVOCATE PARDEEP SIHMAR,Peoples Party of India (Democratic),871,5,876,S074
5825,AJIT SINGH,Independent,794,2,796,S074
5826,DEV GIRI,Rashtriya Lokswaraj Party,719,7,726,S074
5827,DINESH KUMAR,Independent,699,4,703,S074
5828,MASTER VIJENDER JITPURA,Socialist Unity Centre Of India (COMMUNIST),654,3,657,S074
5829,RAJENDER KUMAR,Independent,485,1,486,S074
5830,NEERAJ KUMAR “CHHATTAR”,Bharatiya Asha Party,419,4,423,S074
5831,MANDEEP,Independent,404,1,405,S074
5832,JAGAT SINGH,Vikas India Party,374,8,382,S074
5833,PARJAPATI RAKESH DHUWARIA,Independent,372,2,374,S074
5834,RANDHIR SINGH,Independent,352,1,353,S074
5835,SURENDER KUMAR,Independent,326,0,326,S074
5836,SURENDER,Independent,308,0,308,S074
5837,VIJAY SINGH,Independent,270,2,272,S074
5838,YOGESH BOORA,Independent,267,2,269,S074
5839,NOTA,None of the Above,3333,33,3366,S074
5840,HARIBHAI PATEL,Bharatiya Janata Party,675614,10792,686406,S064
5841,RAMJI THAKOR,Indian National Congress,352578,5782,358360,S064
5842,AMRUTLAL MAKWANA,Bahujan Samaj Party,9710,164,9874,S064
5843,CHAUHAN PRAKASHKUMAR TRIBHOVANDAS,Akhila Vijaya Party,3866,16,3882,S064
5844,PATEL MANUBHAI SHANKARLAL,Independent,3597,75,3672,S064
5845,ZALA VIKRAMSINH BANESINH,Rashtra Nirman Party,2949,58,3007,S064
5846,NOTA,None of the Above,11002,624,11626,S064
5847,CHAVDA VINOD LAKHAMSHI,Bharatiya Janata Party,656979,2595,659574,S061
5848,NITESH PARBATBHAI LALAN (MATANG),Indian National Congress,389384,1408,390792,S061
5849,VIJAY BHACHRA,Bahujan Samaj Party,6075,36,6111,S061
5850,VANAZARA HIRABEN DALPATBHAI,Independent,5145,6,5151,S061
5851,BABULAL LADHA CHAVDA,Independent,3348,6,3354,S061
5852,KAVITABEN DINESHBHAI MACHCHHOYA,Independent,3342,24,3366,S061
5853,DEVABHAI MITHABHAI GOHIL,Rashtriya Power Party,2087,14,2101,S061
5854,SHAMLIA VIRJI CHAKU,Hindvi Swarajyay Dal,1560,13,1573,S061
5855,ARVIND ASHOK SANGHELA,Gujarat Sarva Samaj Party,1509,17,1526,S061
5856,BOCHIYA BHIMJI BHIKHA,Sarva Samaj Janata Party,1491,6,1497,S061
5857,RAMJIBHAI JAKHUBHAI DAFDA,Right to Recall Party,1357,13,1370,S061
5858,NOTA,None of the Above,18604,138,18742,S061
5859,SHASHI THAROOR,Indian National Congress,353679,4476,358155,S1120
5860,RAJEEV CHANDRASEKHAR,Bharatiya Janata Party,337920,4158,342078,S1120
5861,PANNIAN RAVINDRAN,Communist Party of India,244433,3215,247648,S1120
5862,ADV RAJENDRAN,Bahujan Samaj Party,2315,37,2352,S1120
5863,ADV SHINE LAL M P,Independent,1446,37,1483,S1120
5864,J J RUSSELL,Independent,1348,17,1365,S1120
5865,S MINI,Socialist Unity Centre Of India (COMMUNIST),1098,11,1109,S1120
5866,M S SUBI,Independent,588,11,599,S1120
5867,CHALAI MOHANAN,Independent,396,4,400,S1120
5868,NANDAVANAM SUSEELAN,Independent,391,29,420,S1120
5869,SHAJU PALIYODU,Independent,348,40,388,S1120
5870,SASI KONGAPALLY,Independent,228,5,233,S1120
5871,NOTA,None of the Above,6684,69,6753,S1120
5872,DR. ALOK KUMAR SUMAN,Janata Dal  (United),510329,1537,511866,S0417
5873,PREM NATH CHANCHAL ALIAS CHANCHAL PASWAN,Vikassheel Insaan Party,383065,1621,384686,S0417
5874,DINANATH MANJHI,All India Majlis-E-Ittehadul Muslimeen,29900,92,29992,S0417
5875,SUJEET KUMAR RAM,Bahujan Samaj Party,29145,127,29272,S0417
5876,ANIL RAM,Independent,12988,14,13002,S0417
5877,SATYENDRA BAITHA,Independent,12253,16,12269,S0417
5878,BHOLA HARIJAN,Independent,11138,2,11140,S0417
5879,RAM KUMAR MANJHI,Gana Suraksha Party,8531,9,8540,S0417
5880,NAMI RAM,Independent,6716,0,6716,S0417
5881,SURENDRA RAM,Bhartiya Rashtriya Dal,6673,39,6712,S0417
5882,JITENDRA RAM,Bahujan Mukti Party,5942,27,5969,S0417
5883,NOTA,None of the Above,42713,150,42863,S0417
5884,HARSH MALHOTRA,Bharatiya Janata Party,663420,1399,664819,U053
5885,KULDEEP KUMAR (MONU),Aam Aadmi Party,570494,662,571156,U053
5886,MOHD. WAQAR CHOUDHARY,Bahujan Samaj Party,9158,39,9197,U053
5887,A. GOPALA KRISHNA,Navarang Congress Party,2807,10,2817,U053
5888,KULDEEP KUMAR,Independent,1579,3,1582,U053
5889,MANOJ KUMAR GUPTA (SWARAJI),Independent,1191,1,1192,U053
5890,RODASH GUPTA,Independent,1097,2,1099,U053
5891,JYOTI PRAKASH (MONU),Ekam Sanatan Bharat Dal,824,0,824,U053
5892,ARUNIMA GAUTAM,Independent,749,2,751,U053
5893,JAI RAM LAL,Rashtriya Republican Party,657,0,657,U053
5894,ADVOCATE MANJEET SINGH,Rashtra Nirman Party,614,0,614,U053
5895,MOHAMMAD IRFAN,Independent,582,1,583,U053
5896,OM SHANKAR,Independent,556,0,556,U053
5897,LAL SINGH,Bahujan Dravida Party,476,1,477,U053
5898,YOGESH CHAUDHARY,Bhartiya Veer Dal,468,2,470,U053
5899,VIMAL KUMAR SAXENA,Independent,427,6,433,U053
5900,SURENDRA SINGH BASOYA,Peoples Party of India (Democratic),392,7,399,U053
5901,SANJAY,Public Political Party,378,1,379,U053
5902,AMIT GUPTA,Independent,358,2,360,U053
5903,SANJAYA KUMAR YADAV,Right to Recall Party,289,1,290,U053
5904,NOTA,None of the Above,5371,23,5394,U053
5905,BISHNU PADA RAY,Bharatiya Janata Party,102182,254,102436,U011
5906,KULDEEP RAI SHARMA,Indian National Congress,77829,211,78040,U011
5907,MANOJ PAUL,Andaman Nicobar Democratic Congress,8236,18,8254,U011
5908,D AYYAPPAN,Communist Party of India  (Marxist),6009,8,6017,U011
5909,V.K. ABDUL AZIZ,Independent,2195,8,2203,U011
5910,K J B SELVARAJ,All India Anna Dravida Munnetra Kazhagam,911,3,914,U011
5911,DR ARUN KUMAR MALLIK,Bahujan Samaj Party,714,5,719,U011
5912,RINKU MALA MONDAL,Independent,539,3,542,U011
5913,K VENKAT RAM BABU,Independent,506,1,507,U011
5914,USHA KUMARI,Independent,378,2,380,U011
5915,SALAMAT MONDAL,Socialist Unity Centre Of India (COMMUNIST),349,2,351,U011
5916,ANAND RAMNATH ARLEKAR,Independent,342,0,342,U011
5917,NOTA,None of the Above,1802,7,1809,U011
5918,RADHAKRISHNA,Indian National Congress,650623,1698,652321,S105
5919,DR. UMESH G JADHAV,Bharatiya Janata Party,622615,2501,625116,S105
5920,HUCHESHWARA WATHAR GOUR,Bahujan Samaj Party,7871,17,7888,S105
5921,SUNDAR,Independent,3675,2,3677,S105
5922,JYOTI RAMESH CHAVAN,Independent,2787,18,2805,S105
5923,SHARANAPPA (PINTU),Independent,1879,5,1884,S105
5924,TARABAI BHOVI,Independent,1546,4,1550,S105
5925,RAMESH BHIMSING CHAVAN,Independent,1332,2,1334,S105
5926,ANAND SINNUR,Independent,1271,9,1280,S105
5927,NAGENDRA RAO,Uttama Prajaakeeya Party,1211,15,1226,S105
5928,S.M.SHARMA,Socialist Unity Centre Of India (COMMUNIST),1136,8,1144,S105
5929,RAJKUMAR,BhartiyaBahujanKranti Dal,702,7,709,S105
5930,VIJAY JADHAV,Karnataka Rashtra Samithi,555,5,560,S105
5931,B. VIJAYKUMAR CHINCHANSOORKAR,Prahar Janshakti Party,548,6,554,S105
5932,NOTA,None of the Above,8416,13,8429,S105
5933,CHHATRA PAL SINGH GANGWAR,Bharatiya Janata Party,565600,1527,567127,S2425
5934,PRAVEEN SINGH ARON,Samajwadi Party,530825,1498,532323,S2425
5935,IRSHAD ANSARI ADVOCATE,Peace Party,3548,5,3553,S2425
5936,WASEEM MIAN,Independent,2839,0,2839,S2425
5937,BHUPENDRA KUMAR MAURYA,Peoples Party of India (Democratic),1702,2,1704,S2425
5938,BUDDH PRIYA KARMRAJ RAHUL,Independent,1192,2,1194,S2425
5939,ROHTASH KASHYAP,Jan Shakti Ekta Party,844,3,847,S2425
5940,JAGPAL SINGH YADAV,Samrat Mihir Bhoj Samaj Party,654,2,656,S2425
5941,RAVI KUMAR,Sardar Patel Siddhant Party,626,1,627,S2425
5942,MOHD NAJIM ALI,Bharat Jodo Party,624,9,633,S2425
5943,NITIN MOHAN,Independent,619,1,620,S2425
5944,ASHISH GANGWAR,Independent,616,0,616,S2425
5945,AYSHA BI,Independent,550,9,559,S2425
5946,NOTA,None of the Above,6226,34,6260,S2425
5947,MANOJ TIWARI,Bharatiya Janata Party,821567,2884,824451,U052
5948,KANHAIYA KUMAR,Indian National Congress,684501,1172,685673,U052
5949,ASHOK KUMAR,Bahujan Samaj Party,12053,85,12138,U052
5950,SUNITA,Navarang Congress Party,3518,0,3518,U052
5951,AKESHAN DUT,Independent,3325,0,3325,U052
5952,SUSHIL CHOUDHARY,Aapki Apni Party (Peoples),2066,4,2070,U052
5953,AJAY TIWARI,Right to Recall Party,2040,2,2042,U052
5954,SUBHASH,Rashtriya Janmorcha,1639,0,1639,U052
5955,AKASH SRIVASTAV,Jai Hind National Party,1317,0,1317,U052
5956,SANJEEV KUMAR PANDEY,Bharatiya Liberal Party,1163,0,1163,U052
5957,SAROJ KUMAR RAY,Independent,931,66,997,U052
5958,ADV. BHIM KISHOR,Peoples Party of India (Democratic),826,1,827,U052
5959,SANJEEV KUMAR,Public Political Party,799,0,799,U052
5960,PRAKASH DEVI,Socialist Unity Centre Of India (COMMUNIST),676,0,676,U052
5961,LAKSHYA VASHIST (SHYAM),Jindabad Kranti Party,653,0,653,U052
5962,BABITA YADAV,Aazad Samaj Party (Kanshi Ram),646,0,646,U052
5963,MANOJ KUMAR,Independent,559,2,561,U052
5964,NIVEDITA SHARMA “PREM”,Rashtrawadi Janlok Party (Satya),541,2,543,U052
5965,DR. RAJESH KUMAR SINGH,Independent,539,1,540,U052
5966,KANHI LAL,Swatantra Jantaraj Party,496,2,498,U052
5967,VIJAY KUMAR JHA,Independent,486,5,491,U052
5968,YOGESH SWAMY,Independent,410,0,410,U052
5969,ASHOK MISHRA,Independent,352,0,352,U052
5970,ADV. K.T. PALUSKAR,Prabuddha Republican Party,349,0,349,U052
5971,RAVI KIRAN THILAK THATIKONDA,Independent,324,0,324,U052
5972,ISHWAR CHAND,Bharatrashtra Democratic Party,310,0,310,U052
5973,JAGDISH,Rashtriya Samaj Paksha,276,0,276,U052
5974,BIRPAL SINGH KOLI,Independent,269,1,270,U052
5975,NOTA,None of the Above,5845,28,5873,U052
5976,ASHOK KUMAR RAWAT,Bharatiya Janata Party,473971,1045,475016,S2432
5977,SANGITA RAJVANSHI,Samajwadi Party,440157,1453,441610,S2432
5978,B R AHIRWAR,Bahujan Samaj Party,111670,275,111945,S2432
5979,RAMPAL,Independent,3973,5,3978,S2432
5980,LALIT KUMAR,Bhartiya Shakti Chetna Party,3811,4,3815,S2432
5981,Neelam Singh,Independent,2899,6,2905,S2432
5982,VANDNA  VERMA,Naari Nar Rakshak Party,1907,5,1912,S2432
5983,AVDHESH,Independent,1419,4,1423,S2432
5984,SAVITRI DEVI,Rashtriya Janshakti Samaj Party,1347,3,1350,S2432
5985,NOTA,None of the Above,7997,32,8029,S2432
5986,RICHARD VANLALHMANGAIHA,Zoram People’s Movement,206377,2175,208552,S161
5987,K VANLALVENA,Mizo National Front,139532,732,140264,S161
5988,LALBIAKZAMA,Indian National Congress,97761,834,98595,S161
5989,VANLALHMUAKA,Bharatiya Janata Party,33009,524,33533,S161
5990,LALHRIATRENGA CHHANGTE,Independent,4663,43,4706,S161
5991,RITA MALSAWMI,Mizoram People's Conference,3681,112,3793,S161
5992,NOTA,None of the Above,1866,27,1893,S161
5993,KAMLESH JANGDE,Bharatiya Janata Party,675740,2459,678199,S263
5994,DR. SHIVKUMAR DAHARIYA,Indian National Congress,616131,2068,618199,S263
5995,DR. ROHIT DAHARIA,Bahujan Samaj Party,48089,412,48501,S263
5996,ENGINEER REVA KURREY,Independent,8158,1,8159,S263
5997,AD. T.R. NIRALA,Independent,5792,2,5794,S263
5998,ANIL MANHAR,Hamar Raj Party,5770,10,5780,S263
5999,VIDYA DEVI SONI,Independent,4877,4,4881,S263
6000,MINA CHAUHAN,Independent,2929,2,2931,S263
6001,ANAND GILHARE,Independent,2876,1,2877,S263
6002,DEEPAK KUMAR KHUNTE,Aazad Samaj Party (Kanshi Ram),1822,7,1829,S263
6003,ARVIND KUMAR,Independent,1710,5,1715,S263
6004,GOPAL PRASAD KHUNTE,Bhartiya Shakti Chetna Party,1471,12,1483,S263
6005,VIJAYLAXMI SURYAWANSHI NAT,Asankhya Samaj Party,1417,5,1422,S263
6006,SIMA MAHILANGE,Independent,1333,3,1336,S263
6007,ADVOCATE SHAILENDRA BANJARE (SHAKTIPUTRA),Shakti Sena (Bharat Desh),1248,5,1253,S263
6008,VIJAY KUMAR KURRE,Rashtriya Jansabha Party,981,2,983,S263
6009,BRINDA CHAUHAN,Chhattisgarh Vikas Ganga Rashtriya Party,921,3,924,S263
6010,JAGJIVAN RAM SATNAMI,Azad Janata Party,833,4,837,S263
6011,NOTA,None of the Above,5098,39,5137,S263
6012,RAJU BISTA,Bharatiya Janata Party,675324,4007,679331,S254
6013,GOPAL LAMA,All India Trinamool Congress,498789,2017,500806,S254
6014,MUNISH TAMANG,Indian National Congress,82597,777,83374,S254
6015,BANDANA RAI,Independent,13155,519,13674,S254
6016,BISHNU PRASAD SHARMA,Independent,7431,16,7447,S254
6017,BHUPENDRA LEPCHA,Independent,6369,26,6395,S254
6018,ATASI BISWAS,Kisan Mazdoor Sangharsh Party,4586,55,4641,S254
6019,PRADHAN MARDI,Ambedkarite Party of India,2714,33,2747,S254
6020,KHUSHI RANJAN MANDAL,Independent,2313,24,2337,S254
6021,KALICHARAN BARMAN,Independent,2055,24,2079,S254
6022,QAMRUL HAQUE,North Bengal People’s Party,1829,24,1853,S254
6023,BUDHARU ROY,Kamatapur People’s Party (United),1734,28,1762,S254
6024,SHAHRIAR ALAM,Socialist Unity Centre Of India (COMMUNIST),1605,9,1614,S254
6025,SUBODH PAKHRIN,Gorkha Rashtriya Congress,1270,61,1331,S254
6026,NOTA,None of the Above,17960,61,18021,S254
6027,G M HARISH (BALAYOGI),Telugu Desam,786149,10832,796981,S017
6028,RAPAKA VARAPRASADA RAO,Yuvajana Sramika Rythu Congress Party,450362,4423,454785,S017
6029,GOUTHAM JANGA,Indian National Congress,14523,559,15082,S017
6030,DORABABU YALLA,Bahujan Samaj Party,5202,186,5388,S017
6031,KATRU NAGA BABU,Telugu Nava Garjana Party,3736,5,3741,S017
6032,VADDI LALITH KUMAR,Independent,2974,3,2977,S017
6033,MAKEY DAVY PRASAD,Independent,2104,7,2111,S017
6034,GUDE VENKATESWARULU,Independent,1741,4,1745,S017
6035,RAMESH JILLELLA,Jatiya Jana Sena Party,866,6,872,S017
6036,YALANGI RAMESH,Jaibhim Rao Bharat Party,738,2,740,S017
6037,MATHA KRISHNA,Pyramid Party of India,718,1,719,S017
6038,GIDDI JNANA PRAKASA RAO,Republican Party of India,717,9,726,S017
6039,YADLA RAJESH,Liberation Congress Party,628,7,635,S017
6040,KAPA KALYAN,Republican Party of India (A),579,2,581,S017
6041,PATHURI RAMESH,Peoples Party of India (Democratic),502,3,505,S017
6042,NOTA,None of the Above,13418,100,13518,S017
6043,TANUJ PUNIA,Indian National Congress,718528,1399,719927,S2453
6044,RAJRANI RAWAT,Bharatiya Janata Party,503452,771,504223,S2453
6045,SHIV KUMAR DOHAREY,Bahujan Samaj Party,39105,72,39177,S2453
6046,BABOORAM,Independent,3669,0,3669,S2453
6047,RAMLAKHAN PASI,Independent,2927,1,2928,S2453
6048,MITHALESH KUMARI,Independent,2320,1,2321,S2453
6049,DEVATADEEN GAUTAM,Independent,2172,1,2173,S2453
6050,ASHA DEVI,Swatantrata Abhivyakti Party,2018,2,2020,S2453
6051,PROF. (DR.) RAM GHULAM RAZDAN,Public Adhikar Socialist Indian Party,1493,0,1493,S2453
6052,MAHENDRA KUMAR RAWAT,Awami Samta Party,1189,1,1190,S2453
6053,OMKAR,Independent,1137,1,1138,S2453
6054,ADVOCATE SANTOSH RAWAT,Dr. Bhimrao Ambedkar Dal,1076,2,1078,S2453
6055,PREMCHANDRA HARIJAN,Sardar Patel Siddhant Party,1075,1,1076,S2453
6056,NOTA,None of the Above,8220,1,8221,S2453
6057,RAHUL KASWAN,Indian National Congress,719352,8859,728211,S203
6058,DEVENDRA JHAJHARIA,Bharatiya Janata Party,647891,7583,655474,S203
6059,DEIRAM MEGHWAL,Bahujan Samaj Party,11145,126,11271,S203
6060,RAMESH KUMAR,Independent,5720,4,5724,S203
6061,GOMATI DHARAMPAL KATARIA,Bharat Rakshak Party (Democratic),4937,24,4961,S203
6062,SUKHDEV,Independent,4550,9,4559,S203
6063,RANVEER SINGH,Independent,1809,3,1812,S203
6064,BISAN SINGH,Independent,1571,73,1644,S203
6065,DAULAT RAM PENSIA,National Janmandal Party,1178,15,1193,S203
6066,YUSUF ALI KHAN,Independent,1176,54,1230,S203
6067,SHISHPAL SINGH RANA,Bheem Tribal Congress,671,4,675,S203
6068,NIRANJAN SINGH RATHORE,Independent,648,20,668,S203
6069,ASLAM LILGAR,Independent,558,9,567,S203
6070,NOTA,None of the Above,6583,73,6656,S203
6071,AMRINDER SINGH RAJA WARRING,Indian National Congress,321424,800,322224,S197
6072,RAVNEET SINGH BITTU,Bharatiya Janata Party,300927,355,301282,S197
6073,ASHOK PRASHAR PAPPI,Aam Aadmi Party,236620,457,237077,S197
6074,RANJIT SINGH DHILLON,Shiromani Akali Dal,90073,147,90220,S197
6075,KAMALJIT SINGH BRAR,Independent,42462,38,42500,S197
6076,AMRITPAL SINGH CHHANDRAN,Shiromani Akali Dal (Amritsar)(Simranjit Singh Mann),18199,42,18241,S197
6077,DAVINDER SINGH RAMGARHIA,Bahujan Samaj Party,10365,29,10394,S197
6078,NARESH DHINGAAN,Independent,2524,6,2530,S197
6079,RAKESH KUMAR (RICKY),Sunahara Bharat Party,2091,0,2091,S197
6080,ER. BALDEV RAJ KATNA (DEBI),Independent,2086,0,2086,S197
6081,PRITPAL SINGH,Bahujan Dravida Party,1821,3,1824,S197
6082,DR. PALWINDER KAUR,Independent,1766,2,1768,S197
6083,SANJEEV KUMAR (SANJU),Independent,1567,0,1567,S197
6084,RAJIV KUMAR MEHRA,Jan Sewa Driver Party,1516,2,1518,S197
6085,BHUPINDER SINGH,Bharatheeya Jawan Kisan Party,1287,0,1287,S197
6086,BALJIT SINGH,Independent,1137,1,1138,S197
6087,VIPAN KUMAR BATRA,Independent,1041,0,1041,S197
6088,AMANDEEP SINGH,Sehajdhari Sikh Party,981,6,987,S197
6089,PARAMJIT SINGH,Independent,927,0,927,S197
6090,BALVINDER SINGH BITTA,Independent,918,0,918,S197
6091,SIMRANDEEP SINGH,Independent,911,1,912,S197
6092,DEVINDER BHAGRIA,Hindustan Shakti Sena,859,1,860,S197
6093,KANIYA LAL (DR. KISHAN KUMAR),Independent,820,0,820,S197
6094,SUDHIR KUMAR TRIPATHI,Independent,770,0,770,S197
6095,GURDEEP SINGH KAHLON,Independent,738,0,738,S197
6096,DR. DEVINDER SINGH GILL,Aam Lok Party United,693,2,695,S197
6097,KIRPAL SINGH KAPURI,Independent,621,0,621,S197
6098,SANTOSH KUMAR,Bharatiya Inqalab Party,610,0,610,S197
6099,KAMAL PAWAR,Independent,592,0,592,S197
6100,RAVINDER PAL SINGH BABA JI BARGAR WALE,Independent,546,2,548,S197
6101,GURMEET SINGH KHARAY,Independent,516,1,517,S197
6102,RUPINDER KUMAR,Independent,467,0,467,S197
6103,CHANDI,Independent,456,0,456,S197
6104,BALDEV SINGH SUMAN,Independent,450,0,450,S197
6105,JAI - PARKASH JAIN (TITU BANIYA),Independent,419,0,419,S197
6106,SHIVAM YADAV,Global Republican Party,414,1,415,S197
6107,HARVINDER KAUR,Samajik Sangharsh Party,413,6,419,S197
6108,BHOLA SINGH,Independent,411,0,411,S197
6109,DARSHAN SINGH DABA,Nationalist Justice Party,390,0,390,S197
6110,KULDEEP KUMAR SHARMA,Independent,383,0,383,S197
6111,VISHAL KUMAR ARORA,Independent,344,0,344,S197
6112,KARNAIL SINGH,Independent,340,0,340,S197
6113,RAJINDER GHAI,Independent,284,0,284,S197
6114,NOTA,None of the Above,5040,36,5076,S197
6115,RADHA MOHAN SINGH,Bharatiya Janata Party,540598,1595,542193,S043
6116,DR RAJESH KUMAR,Vikassheel Insaan Party,451118,2788,453906,S043
6117,MOHAMMAD AJMER ALAM,Independent,13030,17,13047,S043
6118,VIJAY KUMAR SAHANI,Rashtriya Jansambhavna Party,8158,27,8185,S043
6119,RAJESH SINGH,Independent,7176,6,7182,S043
6120,GYANTI DEVI,Prabuddha Republican Party,6963,45,7008,S043
6121,PAWAN KUMAR,Bhartiya Sarthak Party,4895,19,4914,S043
6122,MUNESHWAR TIWARI,Independent,4017,5,4022,S043
6123,RAJESH KUMAR S/O GAGANLAL SAHNI,Independent,3930,4,3934,S043
6124,RAJESH KUMAR S/O VISHUN SAH,Independent,3489,3,3492,S043
6125,NAWAL KISHOR PRASAD,Viro Ke Vir Indian Party,3449,15,3464,S043
6126,NIKESH KUMAR,Independent,2539,14,2553,S043
6127,NOTA,None of the Above,19729,59,19788,S043
6128,JANARDAN MISHRA,Bharatiya Janata Party,475439,2020,477459,S1210
6129,NEELAM ABHAY MISHRA,Indian National Congress,283187,898,284085,S1210
6130,ADV. ABHISHEK MASTER BUDDHSEN PATEL,Bahujan Samaj Party,117089,132,117221,S1210
6131,DAYASHANKAR PANDEY,Independent,4609,1,4610,S1210
6132,ROSHAN LAL KOL,Independent,4110,12,4122,S1210
6133,ER. DEVENDRA SINGH,Sapaks Party,4065,11,4076,S1210
6134,ER. RAM KUMAR SONI,Independent,3868,5,3873,S1210
6135,RAM GOPAL SINGH,Peoples Party of India (Democratic),3502,7,3509,S1210
6136,PRASSAN JEET SINGH,Independent,3306,7,3313,S1210
6137,JANARDAN MISHRA,Independent,2274,21,2295,S1210
6138,RANJAN GUPTA,Rashtravadi Bharat Party,2151,9,2160,S1210
6139,VIPIN SINGH PATEL,Rashtriya Hind Ekta Dal,1799,7,1806,S1210
6140,ARUNENDRA NARAYAN PANDEY,Independent,1550,1,1551,S1210
6141,ARUN TIWARI 'MINTU',Independent,1113,0,1113,S1210
6142,NOTA,None of the Above,6916,20,6936,S1210
6143,MANSUKHBHAI DHANJIBHAI VASAVA,Bharatiya Janata Party,605489,2668,608157,S0622
6144,CHAITARBHAI DAMJIBHAI VASAVA,Aam Aadmi Party,518419,4042,522461,S0622
6145,DILIPBHAI CHHOTUBHAI VASAVA,Bharat Adivasi Party,9981,33,10014,S0622
6146,SAJID YAKUB MUNSHI,Independent,9934,3,9937,S0622
6147,VASAVA CHETANBHAI KANJIBHAI,Bahujan Samaj Party,6312,12,6324,S0622
6148,NAVINBHAI BHIKHABHAI PATEL,Independent,3440,13,3453,S0622
6149,YUSUF VALI HASANALI,Independent,3245,2,3247,S0622
6150,GITABEN MANUBHAI MACHHI,Malwa Congress,2750,14,2764,S0622
6151,MITESHBHAI THAKORBHAI PADHIYAR,Independent,2451,8,2459,S0622
6152,MIRZA AABIDBEG YASINBEG,Independent,2043,7,2050,S0622
6153,ISMAIL AHMAD PATEL,Independent,1887,15,1902,S0622
6154,NARAYANBHAI LILADHARJI RAVAL,Independent,1574,9,1583,S0622
6155,DHARMESHKUMAR VISHNUBHAI VASAVA,Independent,1324,6,1330,S0622
6156,NOTA,None of the Above,23151,132,23283,S0622
6157,TANGELLA UDAY SRINIVAS  (TEA TIME UDAY),Janasena Party,718971,10728,729699,S016
6158,CHALAMALASETTY SUNIL,Yuvajana Sramika Rythu Congress Party,495188,5020,500208,S016
6159,MALLIPUDI MANGAPATI PALLAM RAJU,Indian National Congress,20258,851,21109,S016
6160,UDAY,Navarang Congress Party,15578,125,15703,S016
6161,KANDREGULA NARASIMHAM,Bahujan Samaj Party,11916,63,11979,S016
6162,DR ANUSHA YADAV,Bharatha Chaitanya Yuvajana Party,9818,36,9854,S016
6163,TANGELLA SRINIVASU,Jatiya Jana Sena Party,6516,43,6559,S016
6164,YEDIDA VARA PRASAD KUMAR,Republican Party of India (A),3924,3,3927,S016
6165,BUGATHA BANGARRAO,Communist Party of India  (Marxist-Leninist)  (Liberation),2816,7,2823,S016
6166,SUDHA VEERA GANESH,Independent,2645,2,2647,S016
6167,BHAVANI SANKAR PRASAD MERLA,Independent,1963,6,1969,S016
6168,YENUGUPALLI KRISHNA,Jaibhim Rao Bharat Party,1762,18,1780,S016
6169,BODDETI APPARAO,Independent,1687,0,1687,S016
6170,NEELAKANTAM DONAM,Independent,1401,11,1412,S016
6171,PASUPULETI S.V.S.BHUSHANAM,Independent,1222,5,1227,S016
6172,NOTA,None of the Above,17105,115,17220,S016
6173,SATPAL BRAHAMCHARI,Indian National Congress,546163,2519,548682,S076
6174,MOHAN LAL BADOLI,Bharatiya Janata Party,525069,1797,526866,S076
6175,UMESH KUMAR,Bahujan Samaj Party,12742,80,12822,S076
6176,ANOOP SINGH,Indian National Lok Dal,11384,139,11523,S076
6177,BHUPENDER SINGH MALIK,Jannayak Janta Party,7716,104,7820,S076
6178,SANT DHARAMVEER CHOTIVALA,Independent,2150,4,2154,S076
6179,RAMESH,Independent,1651,0,1651,S076
6180,NARESH KASHYAP,Aam Aadmi Parivartan Party,1622,36,1658,S076
6181,SATPAL,Independent,1215,2,1217,S076
6182,GAUBHAGAT SUMIT LATHER,Independent,877,5,882,S076
6183,DR. KAMLESH KUMAR SAINI,Independent,863,3,866,S076
6184,ROHTASH,Independent,775,2,777,S076
6185,BALBIR SINGH,Socialist Unity Centre Of India (COMMUNIST),765,3,768,S076
6186,ASHWANI,Independent,694,1,695,S076
6187,SANJAY DASS,Independent,569,3,572,S076
6188,JAGBEER,Independent,521,3,524,S076
6189,SUNIL KUMAR,Rashtriya Garib Dal,456,11,467,S076
6190,RADHEY SHYAM,Peoples Party of India (Democratic),438,3,441,S076
6191,RAKESH,Samata Party,407,3,410,S076
6192,NIRMAL SINGH,Independent,317,1,318,S076
6193,SURENDER SINGH,Independent,295,1,296,S076
6194,RAKESH DHARIWAL,Rashtriya Jatigat Aarakshan Virodhi Party,214,1,215,S076
6195,NOTA,None of the Above,2287,33,2320,S076
6196,"ANNADURAI, C.N.",Dravida Munnetra Kazhagam,543857,3522,547379,S2211
6197,KALIYAPERUMAL M,All India Anna Dravida Munnetra Kazhagam,311384,2064,313448,S2211
6198,"ASUVATHAMAN, A.",Bharatiya Janata Party,154736,1914,156650,S2211
6199,"RAMESHBABU,  R.",Naam Tamilar Katchi,83148,721,83869,S2211
6200,"KALIAPERUMAL, M.",Independent,5704,9,5713,S2211
6201,"BENNYRAJAN, C.J.",Bharatiya Praja Aikyata Party,4703,107,4810,S2211
6202,"KALIYAPERUMAL, A.",Independent,3402,5,3407,S2211
6203,"MOHANRAJA,  V.M.",Bahujan Samaj Party,2615,22,2637,S2211
6204,CAPTAIN GOWTHAM,Independent,1823,19,1842,S2211
6205,"UDHAYAKUMAR, P.S.",Independent,1246,5,1251,S2211
6206,"ANNADURAI, S.",Independent,1165,7,1172,S2211
6207,"KOTHANDABANI, B.",Independent,963,2,965,S2211
6208,"SELVAM , K.",Veerath Thiyagi Viswanathadoss Thozhilalarkal Katchi,945,9,954,S2211
6209,"KALASTHIRI,  S.",All India Uzhavargal Uzhaippalargal Katchi,934,16,950,S2211
6210,"VIJAYAKUMAR,  S.",Independent,928,6,934,S2211
6211,"JAGANNATHAN,  R.",Independent,857,7,864,S2211
6212,"SENTHAMIL SELVAN,  M.",Independent,848,8,856,S2211
6213,"AGNI SELVARASU, J.",Naadaalum Makkal Katchi,759,18,777,S2211
6214,"SATHIYAMOORTHY,  S.",Makkal Nala Kazhagam,716,20,736,S2211
6215,"ANNADURAI, S.",Independent,642,6,648,S2211
6216,"SUB MAJOR SETTU, M.",Viro Ke Vir Indian Party,636,22,658,S2211
6217,"SANKAR,  S.",Independent,569,9,578,S2211
6218,"ANNADURAI, A.",Independent,482,34,516,S2211
6219,"NALLASIVAM, M.",Independent,426,3,429,S2211
6220,"PALANI , T.N.",Independent,413,1,414,S2211
6221,"POONGODY,  A.",Independent,412,5,417,S2211
6222,"VIMAL, V.",Independent,341,1,342,S2211
6223,"THANGARAJ,  P.",Independent,291,4,295,S2211
6224,"RAMESH , T.P.",Independent,280,1,281,S2211
6225,"NAKKEERAN ,  A.",Independent,260,5,265,S2211
6226,DEEPAMMAL SUNDARI,Independent,252,7,259,S2211
6227,NOTA,None of the Above,11527,430,11957,S2211
6228,MANOJ KUMAR,Indian National Congress,509977,3027,513004,S0434
6229,SHIVESH KUMAR,Bharatiya Janata Party,492177,1670,493847,S0434
6230,SANTOSH KUMAR,Bahujan Samaj Party,45491,107,45598,S0434
6231,SHIV SHANKAR RAM,Independent,8009,10,8019,S0434
6232,SANTOSH KUMAR KHARWAR,Bhartiya Gandhiwadi Party,4817,5,4822,S0434
6233,BANARSI DAS,Peoples Party of India (Democratic),4498,0,4498,S0434
6234,AMIT KUMAR AMBEDKAR,Bahujan Mukti Party,2823,11,2834,S0434
6235,PUNAM DEVI,Jantantra Awaj Party,2634,20,2654,S0434
6236,UJARAN MUSAHAR,Jan Janwadi Party,2616,4,2620,S0434
6237,NANDLAL RAM,Rashtriya Samaj Paksha,1956,4,1960,S0434
6238,NOTA,None of the Above,17160,59,17219,S0434
6239,KIREN RIJIJU,Bharatiya Janata Party,196415,9002,205417,S021
6240,NABAM TUKI,Indian National Congress,100100,4579,104679,S021
6241,TECHI RANA,Independent,31106,2208,33314,S021
6242,TOKO SHEETAL,Gana Suraksha Party,27670,2860,30530,S021
6243,BIMPAK SIGA,Independent,10569,949,11518,S021
6244,RUHI TAGUNG,Independent,7559,262,7821,S021
6245,LEKI NORBU,Independent,2139,132,2271,S021
6246,TANIA JUNE,Independent,1920,38,1958,S021
6247,NOTA,None of the Above,2133,163,2296,S021
6248,GIRIRAJ SINGH,Bharatiya Janata Party,646912,2419,649331,S0424
6249,ABDHESH KUMAR ROY,Communist Party of India,564310,3541,567851,S0424
6250,INDRAJEET KUMAR ROY,Independent,12947,6,12953,S0424
6251,RAJNISH KUMAR MUKHIYA,Rashtriya Jansambhavna Party,10846,26,10872,S0424
6252,ADV CHANDAN KUMAR DAS,Bahujan Samaj Party,8362,91,8453,S0424
6253,RAM BADAN RAI,Karpoori Janta Dal,6599,45,6644,S0424
6254,MD SHAHNAWAZ HASSAN,Independent,6144,8,6152,S0424
6255,ARUN KUMAR,Independent,4030,15,4045,S0424
6256,RAJ KUMAR SAH,Akhil Bhartiya Parivar Party,3329,21,3350,S0424
6257,RAMUDGAR,Socialist Unity Centre Of India (COMMUNIST),2633,7,2640,S0424
6258,NOTA,None of the Above,22283,99,22382,S0424
6259,SANJNA JATAV,Indian National Congress,572808,7082,579890,S209
6260,RAMSWAROOP KOLI,Bharatiya Janata Party,519269,8638,527907,S209
6261,ANJILA JATAV,Bahujan Samaj Party,9298,210,9508,S209
6262,ANEETA,Independent,5027,92,5119,S209
6263,PURUSHOTTAM LAL,Independent,2730,17,2747,S209
6264,PUSHPENDAR KUMAR,Independent,2374,12,2386,S209
6265,NOTA,None of the Above,5344,99,5443,S209
6266,DR DHARAMVIRA GANDHI,Indian National Congress,304672,944,305616,S1913
6267,DR BALBIR SINGH,Aam Aadmi Party,290085,700,290785,S1913
6268,PRENEET KAUR,Bharatiya Janata Party,288470,528,288998,S1913
6269,N K SHARMA,Shiromani Akali Dal,153780,198,153978,S1913
6270,PROF MOHINDER PAL SINGH,Shiromani Akali Dal (Amritsar)(Simranjit Singh Mann),47152,122,47274,S1913
6271,JAGJIT SINGH CHHARBAR,Bahujan Samaj Party,22334,66,22400,S1913
6272,ARVINDER KUMAR,Independent,3808,4,3812,S1913
6273,JAGDISH KUMAR,Independent,3236,3,3239,S1913
6274,SUKHVINDER SINGH,Independent,2885,9,2894,S1913
6275,JODH SINGH PARMAR KAULI,Independent,2795,0,2795,S1913
6276,DEVINDER RAJPUT,Bharatheeya Jawan Kisan Party,2302,9,2311,S1913
6277,NEERAJ KUMAR NANNA,Independent,2299,3,2302,S1913
6278,PARAMJIT SINGH S/O TARLOCHAN SINGH,Independent,2264,3,2267,S1913
6279,AMARJIT SINGH JAGDE RAHO,Jan Janwadi Party,1981,11,1992,S1913
6280,RANJIT SINGH,Akhil Bhartiya Parivar Party,1964,3,1967,S1913
6281,GURBACHAN SINGH,Independent,1589,5,1594,S1913
6282,PARAMJIT SINGH S/O BHAGWAN SINGH,Independent,1565,4,1569,S1913
6283,VISHAL SHARMA,Independent,1474,1,1475,S1913
6284,LABH SINGH PAL,Independent,1443,0,1443,S1913
6285,CHAMKILA SINGH,Independent,1225,3,1228,S1913
6286,KRISHAN KUMAR GABA,Hindustan Shakti Sena,1000,8,1008,S1913
6287,MANDEEP SINGH,Revolutionary Socialist Party,970,3,973,S1913
6288,MAKHAN SINGH,Independent,904,3,907,S1913
6289,DIMPLE,Independent,846,4,850,S1913
6290,BINDER KAUR,Independent,707,4,711,S1913
6291,MANOJ KUMAR,Independent,674,0,674,S1913
6292,NOTA,None of the Above,6641,40,6681,S1913
6293,ADV GOWAAL KAGADA PADAVI,Indian National Congress,744879,1119,745998,S131
6294,DR HEENA VIJAYKUMAR GAVIT,Bharatiya Janata Party,585847,1031,586878,S131
6295,ANANDA SUKALAL KOLI,Bahujan Samaj Party,10628,16,10644,S131
6296,SUSHILKUMAR JAHANGIR PAWARA,Independent,8878,9,8887,S131
6297,NIRMALA VASAVE,Peoples Party of India (Democratic),6923,24,6947,S131
6298,ROHIDAS GEMAJI VALVI,Independent,4941,6,4947,S131
6299,HEMANT MANSARAM KOLI,Vanchit Bahujan  Aaghadi,4062,19,4081,S131
6300,DEEPAKKUMAR MADHUKAR SHIRSATH,Independent,3567,4,3571,S131
6301,RAVINDRA RANJIT VALVI,Bharat Adivasi Party,2608,17,2625,S131
6302,JALAMSING SUTUM PAWAR,Independent,2583,4,2587,S131
6303,GITANJALI SHASHIKANT KOLI,Independent,2372,9,2381,S131
6304,NOTA,None of the Above,14108,15,14123,S131
6305,AKSHAYA YADAV,Samajwadi Party,541861,1176,543037,S2420
6306,VISHWADEEP SINGH,Bharatiya Janata Party,452946,779,453725,S2420
6307,CHOWDHARY BASHEER,Bahujan Samaj Party,90849,99,90948,S2420
6308,UPENDRA SINGH,Bharatiya Kisan Parivartan Party,7111,8,7119,S2420
6309,RASHMI KANT,Parivartan Samaj Party,2927,3,2930,S2420
6310,PREM DUTT,Rashtra Uday Party,2876,2,2878,S2420
6311,RAJVEER,Independent,1367,13,1380,S2420
6312,NOTA,None of the Above,5273,6,5279,S2420
6313,VISHNU DATT SHARMA (V.D.SHARMA),Bharatiya Janata Party,771014,1760,772774,S128
6314,KAMLESH KUMAR,Bahujan Samaj Party,231163,382,231545,S128
6315,R. B. PRAJAPATI (RAJA BHAIYA) EX.I.A.S.,All India Forward Bloc,50033,182,50215,S128
6316,MOHAMMAD IMRAN,Rashtriya Jansambhavna Party,17853,20,17873,S128
6317,PENTER SUNMAN SINGH LODHI,Independent,10005,6,10011,S128
6318,KAPIL GUPTA BHARTIYA,Akhil Bhartiya Parivar Party,7540,24,7564,S128
6319,LAXMI PRASAD,Independent,6752,12,6764,S128
6320,NANDKISHOR,Peoples Party of India (Democratic),6019,8,6027,S128
6321,PANKAJ MAURYA (KUSHWAHA),Gondvana Gantantra Party,4730,10,4740,S128
6322,BITIAYA AHIRWAR,Independent,4018,8,4026,S128
6323,FIROJKHAN,Independent,3708,5,3713,S128
6324,GIRAN SINGH,Bhartiya Shakti Chetna Party,3485,7,3492,S128
6325,KESHKALI,Rashtriya Jansanchar Dal,2861,11,2872,S128
6326,PANNA LAL TRIPATHI AD.,Indian Peoples Adhikar Party,2794,3,2797,S128
6327,NOTA,None of the Above,16134,23,16157,S128
6328,"SUBBARAYAN, K.",Communist Party of India,470195,2544,472739,S2218
6329,"ARUNACHALAM, P.",All India Anna Dravida Munnetra Kazhagam,345326,1485,346811,S2218
6330,"MURUGANANDAM, A.P.",Bharatiya Janata Party,184066,1256,185322,S2218
6331,"SEETHALAKSHMI, M.K.",Naam Tamilar Katchi,95250,476,95726,S2218
6332,"VELUSAMY, A.",Independent,7089,36,7125,S2218
6333,"PALANI, V.",Bahujan Samaj Party,6013,41,6054,S2218
6334,"SATHISHKUMAR, N.",Independent,2315,21,2336,S2218
6335,"JANARTHANAM, P.",Tamilaga Makkal Thannurimai Katchi,1861,7,1868,S2218
6336,"KANNAN, M.",Independent,1752,13,1765,S2218
6337,"SENGUTTUVAN, M.R.",Independent,1560,7,1567,S2218
6338,"SUBRAMANI, N.",Independent,1341,9,1350,S2218
6339,"MALARVIZHI, G.",Rashtriya Samaj Paksha,1311,14,1325,S2218
6340,"KARTHIKEYAN, P.",Independent,810,14,824,S2218
6341,NOTA,None of the Above,17554,183,17737,S2218
6342,P C MOHAN,Bharatiya Janata Party,657236,1679,658915,S1025
6343,MANSOOR ALI KHAN,Indian National Congress,625368,840,626208,S1025
6344,SATISH CHANDRA. M.,Bahujan Samaj Party,3071,16,3087,S1025
6345,JAYALAKSHMI SUNDARA RAJAN,Independent,2755,6,2761,S1025
6346,SURESH BABU. M. C,Uttama Prajaakeeya Party,1735,4,1739,S1025
6347,K. MANJUNATHA,Independent,1552,4,1556,S1025
6348,S. M. KRISHNA,Independent,1466,8,1474,S1025
6349,MURUGESH. R,Independent,1162,0,1162,S1025
6350,UMA. V.,Independent,820,7,827,S1025
6351,PRAKASH. K,Karnataka Rashtra Samithi,766,13,779,S1025
6352,H. P. SHIVAPRAKASH,Socialist Unity Centre Of India (COMMUNIST),700,7,707,S1025
6353,MODI SAIFULLA,Independent,688,7,695,S1025
6354,ABHAYA SHEELA.,Rashtriya Samaj Dal (R),625,10,635,S1025
6355,KARTHIK. K,Voters Independent Party,594,7,601,S1025
6356,T.R. JAGANNATHA RAO,Bharatiya Prajagala Kalyana Paksha,456,4,460,S1025
6357,VASANTH KUMAR ERAPPA,Independent,439,0,439,S1025
6358,C.M. SHABAZ KHAN,Young Star Empowerment Party,428,1,429,S1025
6359,WHITEFIELD MURUGESH .C,Republican Party of India (Karnataka),376,2,378,S1025
6360,B. KRISHNA PRASAD,"Proutist Bloc, India",324,3,327,S1025
6361,MUKTHAR ALI KHAN,Karnataka Karmikara Paksha,314,0,314,S1025
6362,SYED ASIF BUKHARI,Independent,286,0,286,S1025
6363,RANJITH VISHWA,Samajwadi Janata Party(Karnataka),270,4,274,S1025
6364,RUMAN SHARIFFE,Independent,170,1,171,S1025
6365,YALLAPPA.,Independent,158,2,160,S1025
6366,NOTA,None of the Above,12103,23,12126,S1025
6367,SUNIL KUMAR,Janata Dal  (United),522495,927,523422,S041
6368,DEEPAK YADAV,Rashtriya Janata Dal,422959,1788,424747,S041
6369,PRAVESH KUMAR MISHRA @ ANUP,Independent,23195,30,23225,S041
6370,DINESH AGRAWAL,Independent,19787,23,19810,S041
6371,DURGESH SINGH CHAUHAN,Bahujan Samaj Party,18739,77,18816,S041
6372,CHANDRESHWAR MISHRA,Independent,13590,8,13598,S041
6373,SHAFI MOHAMMAD MIYA,Aazad Samaj Party (Kanshi Ram),13419,13,13432,S041
6374,PARSHURAM SAH,Independent,12142,8,12150,S041
6375,NABA KUMAR SARANIA (HIRA BHAI),Gana Suraksha Party,11420,3,11423,S041
6376,SHAMBHU PRASAD,Independent,10478,20,10498,S041
6377,NOTA,None of the Above,30673,36,30709,S041
6378,JADHAV SANJAY ( BANDU ) HARIBHAU,Shiv Sena (Uddhav Balasaheb Thackrey),596871,4472,601343,S1317
6379,JANKAR MAHADEV JAGANNATH,Rashtriya Samaj Paksha,463764,3518,467282,S1317
6380,PANJAB UTTAMRAO DAKH,Vanchit Bahujan  Aaghadi,95394,573,95967,S1317
6381,DR. GOVARDHAN BHIWAJI KHANDAGALE,Bahujan Bharat Party,15355,40,15395,S1317
6382,KAMBLE SHIVAJI DEVAJI,Independent,11050,10,11060,S1317
6383,ALAMGIR MOHAMMAD KHAN,Bahujan Samaj Party,10972,90,11062,S1317
6384,SAMIR GANESHRAO DUDHGAONKAR,Independent,10951,105,11056,S1317
6385,KRUSHNA TRIMBAKRAO PAWAR,Independent,10145,9,10154,S1317
6386,KAILAS BALIRAM PAWAR (NAIK),Baliraja Party,9487,33,9520,S1317
6387,PROF. DR. VILAS BANSIDHAR TANGADE,Independent,8814,6,8820,S1317
6388,ARJUN DNYANOBA BHISE,Independent,6915,8,6923,S1317
6389,COMRADE RAJAN KSHIRSAGAR,Communist Party of India,6627,22,6649,S1317
6390,KISHORKUMAR PRAKASH SHINDE,Independent,6547,1,6548,S1317
6391,KISHORE RADHAKISHAN DHAGE,Independent,5446,34,5480,S1317
6392,SAYED IRSHAD ALI SAYYED LAYAKH ALI,Social Democratic Party Of India,4629,15,4644,S1317
6393,DASHARATH PRABHKAR RATHOD,Maharashtra Vikas Aghadi,4354,40,4394,S1317
6394,KARBHARI KUNDLIK MITHE,Independent,4268,8,4276,S1317
6395,APPASAHEB OMKAR KADAM,Independent,3883,8,3891,S1317
6396,SHRIRAM BANSILAL JADHAV,Jai Sewalal Bahujan Vikas Party,3617,11,3628,S1317
6397,COMRADE GANPAT BHISE,Independent,3589,15,3604,S1317
6398,DNYANESHWAR JAGANNATH DAHIBHATE,Independent,3538,1,3539,S1317
6399,ANIL MANIKRAO MUDGALKAR,Independent,3531,2,3533,S1317
6400,GOVIND BHAIYYA RAMRAO DESHMUKH,Independent,3452,7,3459,S1317
6401,SUBHASH DATTARAV JAVLE,Independent,3429,5,3434,S1317
6402,RAJABHAU SHESHRAO KAKDE,Independent,3299,3,3302,S1317
6403,RAJENDRA RAMDAS ATKAL,Independent,2807,5,2812,S1317
6404,SAYYD ABDUL SATTAR AJIJ,Independent,2646,4,2650,S1317
6405,SHAIKH SALEEM SHAIKH IBRAHIM,All India Majlis-E-Inquilab-E-Millat,2617,2,2619,S1317
6406,SANGEETA VYAKANTRAO GIRI,Swarajya Shakti Sena,2324,15,2339,S1317
6407,ADV. VINOD CHHAGANRAO AMBHORE,Bahujan Mukti Party,2017,24,2041,S1317
6408,VIJAY ANNASAHEB THOMBARE,Independent,1957,2,1959,S1317
6409,VISHNUDAS SHIVAJI BHOSALE,Independent,1856,4,1860,S1317
6410,MUSTAFA MAINODDIN SHAIKH,Independent,1298,4,1302,S1317
6411,BOBADE SAKHARAM PADEGAONKAR,Independent,1244,2,1246,S1317
6412,NOTA,None of the Above,3306,79,3385,S1317
6413,MANNA LAL RAWAT,Bharatiya Janata Party,732757,5529,738286,S2019
6414,TARACHAND MEENA,Indian National Congress,473167,3511,476678,S2019
6415,PRAKASH CHAND,Bharat Adivasi Party,215390,1748,217138,S2019
6416,DALPAT RAM GARASIA,Bahujan Samaj Party,14427,33,14460,S2019
6417,DR. SAVITA KUMARI AHARI,Independent,8130,32,8162,S2019
6418,PRABHULAL MEENA,Independent,7972,24,7996,S2019
6419,RAJENDRA KUMAR MEENA,Indian Peoples Green Party,6752,25,6777,S2019
6420,KANJI LAL DAMOR,Independent,5912,19,5931,S2019
6421,NOTA,None of the Above,22848,100,22948,S2019
6422,SURESH GOPI,Bharatiya Janata Party,409302,3036,412338,S1110
6423,ADV V S SUNILKUMAR,Communist Party of India,334462,3190,337652,S1110
6424,K MURALEEDHARAN,Indian National Congress,324810,3314,328124,S1110
6425,ADV P K NARAYANAN,Bahujan Samaj Party,1985,34,2019,S1110
6426,SUNILKUMAR SON OF PRABHAKARAN,Independent,1930,22,1952,S1110
6427,DIVAKARAN PALLATH,New Labour Party,812,7,819,S1110
6428,M S JAFARGHAN,Independent,689,9,698,S1110
6429,PRATHAPAN,Independent,685,24,709,S1110
6430,JOSHI VILLADOM,Independent,460,33,493,S1110
6431,NOTA,None of the Above,6046,26,6072,S1110
6432,PRABHAKAR REDDY VEMIREDDY,Telugu Desam,750771,15431,766202,S0122
6433,VENUMBAKA VIJAYASAI REDDY,Yuvajana Sramika Rythu Congress Party,514375,5925,520300,S0122
6434,KOPPULA RAJU,Indian National Congress,53264,1580,54844,S0122
6435,BHASKAR NASINA,Bahujan Samaj Party,5710,101,5811,S0122
6436,VIVEKA MANNEPALLI,Revolutionary Socialist Party,2794,10,2804,S0122
6437,KOPPALA RAGHU,Independent,2010,5,2015,S0122
6438,GAJULA SOMA SEKHAR,Jai Bharat National Party,1775,4,1779,S0122
6439,SHAIK MUZIBUR RAHAMAN,Pyramid Party of India,1315,15,1330,S0122
6440,SHAIK MAHABOOB BASHA (MABU),Republican Party of India (A),1228,5,1233,S0122
6441,MALLEPALLY RAGHU,Navarang Congress Party,1104,1,1105,S0122
6442,SHAIK SHAFI AHMED,All India Forward Bloc,1037,0,1037,S0122
6443,NAKKA DINESH,Bharatha Chaitanya Yuvajana Party,576,24,600,S0122
6444,TALARI VENKATAIAH,Jaibhim Rao Bharat Party,553,5,558,S0122
6445,PUNGANURU PRASANNA GANAPATHI,Radical Party of India (Ambedkarist),452,2,454,S0122
6446,NOTA,None of the Above,15454,123,15577,S0122
6447,CAPTAIN  VIRIATO FERNANDES,Indian National Congress,216022,1814,217836,S052
6448,PALLAVI SHRINIVAS DEMPO,Bharatiya Janata Party,201806,2495,204301,S052
6449,RUBERT PEREIRA,Revolutionary Goans Party,18718,167,18885,S052
6450,DR SWETA GAONKAR,Bahujan Samaj Party,1545,36,1581,S052
6451,DEEPKUMAR D MAPARI,Independent,1309,8,1317,S052
6452,DR KALIDAS VAINGANKAR,Independent,707,13,720,S052
6453,ALEXY FERNANDES,Independent,526,16,542,S052
6454,HARISHCHANDRA SUDHAKAR NAIK,Corruption Abolition Party,487,14,501,S052
6455,NOTA,None of the Above,4804,33,4837,S052
6456,LAVU SRIKRISHNA DEVARAYALU,Telugu Desam,798097,9899,807996,S0114
6457,ANIL KUMAR POLUBOINA,Yuvajana Sramika Rythu Congress Party,642186,6081,648267,S0114
6458,GARNEPUDI ALEXANDER SUDHAKAR,Indian National Congress,17520,526,18046,S0114
6459,ORSU PREMARAJU,Bahujan Samaj Party,5276,33,5309,S0114
6460,KUCHIPUDI JOHN BABU,Jaibhim Rao Bharat Party,2328,8,2336,S0114
6461,GARLAPATI SUBHASH PREM,Revolutionary Socialist Party,1243,2,1245,S0114
6462,YAMPATI VEERANJANEYA REDDY,Independent,1056,1,1057,S0114
6463,SUBBARAO CHALLA,Independent,1051,0,1051,S0114
6464,ABDUL RAJAK SHAIK,Independent,718,5,723,S0114
6465,KOTA POTHURAJU,Pyramid Party of India,667,3,670,S0114
6466,P VENKATESH,Jaathia Chethi Vruthula Ikya Vedika Party,385,3,388,S0114
6467,PASUPULETI PICHAIAH,National Nava Kranthi Party,353,3,356,S0114
6468,PAPPULA SAMBASIVA RAO,Navarang Congress Party,331,1,332,S0114
6469,DOCTOR GODA RAMESH KUMAR,Jatiya Jana Sena Party,305,4,309,S0114
6470,THOKALA NAGA RAJU,All India Forward Bloc,277,8,285,S0114
6471,NOTA,None of the Above,11120,79,11199,S0114
6472,C R PATIL,Bharatiya Janata Party,1023366,7699,1031065,S0625
6473,NAISHADHBHAI BHUPATBHAI  DESAI,Indian National Congress,254567,2947,257514,S0625
6474,MALKHAN RAMKISHOR VARMA,Bahujan Samaj Party,8076,57,8133,S0625
6475,KIRIT L. SURATI,Independent,4190,21,4211,S0625
6476,RAJU VARDE,Independent,3139,45,3184,S0625
6477,RAMZAN MANSURI (SENIOR JOURNALIST),Log Party,2652,1,2653,S0625
6478,KADIR MAHEBOOB SAIYED,Social Democratic Party Of India,2527,11,2538,S0625
6479,SHEKH MOHMMAD NISHAR (MUNNABHAI GARAGE),Independent,1481,2,1483,S0625
6480,DR. KANUBHAI KHADADIYA,Socialist Unity Centre Of India (COMMUNIST),1470,15,1485,S0625
6481,SUMANBEN  KHUSHWA (HANSIKA RAJPUT),Sardar Vallabhbhai Patel Party,1397,29,1426,S0625
6482,ADVOCATE NAVINKUMAR SHANKERBHAI PATEL,Independent,1091,4,1095,S0625
6483,MOHAMMAD HANIF SHAH,Garib Kalyan Party,1089,8,1097,S0625
6484,CHANDANSINGH SHIVBADANSINGH THAKUR,Independent,1070,17,1087,S0625
6485,KAZI AYAZ HUSNUDDIN,Independent,775,8,783,S0625
6486,NOTA,None of the Above,19653,809,20462,S0625
6487,MAHESH KASHYAP,Bharatiya Janata Party,456573,1825,458398,S2610
6488,KAWASI LAKHMA,Indian National Congress,402378,775,403153,S2610
6489,PHULSINGH KACHLAM,Communist Party of India,35850,37,35887,S2610
6490,AYTU RAM MANDAVI,Bahujan Samaj Party,19615,32,19647,S2610
6491,SUNDAR BAGHEL,Independent,14203,4,14207,S2610
6492,PRAKASH KUMAR GOTA,Independent,11209,36,11245,S2610
6493,KANWAL SINGH BAGHEL,Rashtriya Jansabha Party,8785,15,8800,S2610
6494,SHIVRAM NAG,Sarv Adi Dal,8269,10,8279,S2610
6495,NARENDRA BURKA,Hamar Raj Party,4382,5,4387,S2610
6496,JAGDISH NAG,Azad Janata Party,3569,23,3592,S2610
6497,TIKAM NAGWANSHI,Gondvana Gantantra Party,3030,12,3042,S2610
6498,NOTA,None of the Above,36733,25,36758,S2610
6499,SHAMBHAVI,Lok Janshakti Party(Ram Vilas),579095,691,579786,S0423
6500,SUNNY HAZARI,Indian National Congress,391558,977,392535,S0423
6501,SHASHI BHUSHAN DAS,Independent,25953,4,25957,S0423
6502,RAVI RAUSHAN KUMAR,Independent,16151,4,16155,S0423
6503,RAM LAKHAN  MAHTO,Bahujan Samaj Party,12698,34,12732,S0423
6504,PINKU PASWAN,Rashtriya Jansambhavna Party,12426,11,12437,S0423
6505,MUKESH CHAUPAL,Independent,5574,5,5579,S0423
6506,JIBACHH KUMAR HAJARI,Independent,4686,8,4694,S0423
6507,RATAN BIHARI,Desh Janhit Party,3411,8,3419,S0423
6508,VIDYA NAND RAM,Wazib Adhikar Party,3110,2,3112,S0423
6509,AMRITA KUMARI,Independent,2849,3,2852,S0423
6510,LAL BABU MAHTO,Sathi Aur Aapka Faisala Party,2665,1,2666,S0423
6511,NOTA,None of the Above,32645,23,32668,S0423
6512,VIVEK THAKUR,Bharatiya Janata Party,408537,2071,410608,S0439
6513,SHRAWAN KUMAR,Rashtriya Janata Dal,340562,2376,342938,S0439
6514,BINOD YADAV,Independent,39391,128,39519,S0439
6515,GUNJAN KUMAR,Independent,29444,238,29682,S0439
6516,RANJIT KUMAR,Bahujan Samaj Party,16240,76,16316,S0439
6517,ANAND KUMAR VERMA,Bharat Jan Jagran Dal,7727,9,7736,S0439
6518,GAUTAM KUMAR BABLOO,Bhagidari Party(P),5886,3,5889,S0439
6519,GANAURI PANDIT,Peoples Party of India (Democratic),4558,32,4590,S0439
6520,NOTA,None of the Above,12555,37,12592,S0439
6521,NIMUBEN JAYANTIBHAI BAMBHANIYA (NIMUBEN BAMBHANIYA),Bharatiya Janata Party,707428,9455,716883,S0615
6522,UMESHBHAI NARANBHAI MAKWANA,Aam Aadmi Party,256902,4692,261594,S0615
6523,RATHOD DINESHBHAI LAKHABHAI,Bahujan Samaj Party,9989,141,10130,S0615
6524,ANILBHAI NARENDRABHAI CHAVDA,Swatantrata Abhivyakti Party,7574,45,7619,S0615
6525,PARMAR RAJESHKUMAR PREMJIBHAI,New India United Party,6456,37,6493,S0615
6526,KALANIYA SAGARBHAI POPATBHAI,Aapki Awaaz Party,6039,48,6087,S0615
6527,SANJAYBHAI MAGANBHAI MAKAWANA,Independent,4131,22,4153,S0615
6528,HARSH GOKLANI,Independent,3593,41,3634,S0615
6529,SHRI MULSHANKARBHAI RAGHURAMBHAI CHAUHAN,Independent,3386,20,3406,S0615
6530,SHRI TIDABHAI DEVSHIBHAI,Gujarat Sarva Samaj Party,2641,44,2685,S0615
6531,BHUPATBHAI MOHANBHAI VALA,Right to Recall Party,2370,24,2394,S0615
6532,NARESHBHAI NARANBHAI RATHOD,Independent,1745,20,1765,S0615
6533,BRAHMAKSHTRIYA BHAGVATIBEN KHETSINH,Independent,1562,62,1624,S0615
6534,NOTA,None of the Above,17717,1048,18765,S0615
6535,RAJA RAM SINGH,Communist Party of India  (Marxist-Leninist)  (Liberation),378922,1659,380581,S0435
6536,PAWAN SINGH,Independent,273546,1177,274723,S0435
6537,UPENDRA KUSHWAHA,Rashtriya Lok Morcha,253088,788,253876,S0435
6538,DHEERAJ KUMAR SINGH,Bahujan Samaj Party,23549,108,23657,S0435
6539,RAJA RAM SINGH,Independent,21357,26,21383,S0435
6540,PRIYANKA PRASAD CHOUDHARY,All India Majlis-E-Ittehadul Muslimeen,10983,23,11006,S0435
6541,AJEET KUMAR SINGH,Peoples Party of India (Democratic),9634,19,9653,S0435
6542,VIKASH VINAYAK,Jan Janwadi Party,7661,3,7664,S0435
6543,INDRA RAJ ROUSHAN,Independent,6315,9,6324,S0435
6544,PRADEEP KUMAR JOSHI,Rashtra Sewa Dal,5891,28,5919,S0435
6545,AVADHESH PASAWAN,Bharatiya Aam Awam Party,5527,58,5585,S0435
6546,RAJESHWAR PASWAN,Akhil Hind Forward Bloc (Krantikari),5003,3,5006,S0435
6547,PRAYAG PASWAN,Socialist Unity Centre Of India (COMMUNIST),4641,5,4646,S0435
6548,NOTA,None of the Above,21548,47,21595,S0435
6549,MISHA BHARTI,Rashtriya Janata Dal,612147,1136,613283,S0431
6550,RAM KRIPAL YADAV,Bharatiya Janata Party,526608,1501,528109,S0431
6551,DR S P SHARMA,Hindustan Vikas Dal,15139,1,15140,S0431
6552,HARIKESHWAR RAM,Bahujan Samaj Party,10931,34,10965,S0431
6553,VINDU DEVI,Rashtriya Jansambhavna Party,10741,3,10744,S0431
6554,SHIV KUMAR SINGH,Apna Kisan Party,9011,5,9016,S0431
6555,SANJAY KUMAR SINGH,Bhartiya Sarthak Party,4753,0,4753,S0431
6556,MD FAROOQUE RAZA,All India Majlis-E-Ittehadul Muslimeen,4010,13,4023,S0431
6557,RAM NIRANJAN ROY,Rashtrawadi Chetna Party,3914,1,3915,S0431
6558,MRITUNJAY KUMAR,Bhagidari Party(P),3483,0,3483,S0431
6559,DURGESH NANDAN SINGH,Independent,3104,2,3106,S0431
6560,NAGESHWAR PRASAD,Peoples Party of India (Democratic),2048,3,2051,S0431
6561,SUBHASH KUMAR,Bhartiya Lok Chetna Party,1979,0,1979,S0431
6562,NITESH KUMAR PATEL,Adarsh Jankalyan Dal,1816,1,1817,S0431
6563,RANJAN KUMAR,Independent,1807,2,1809,S0431
6564,NIRAJ KUMAR,Independent,1767,4,1771,S0431
6565,KUNAL KUMAR,Hamara Sahara Party,1607,7,1614,S0431
6566,KHUSHBOO KUMARI,Akhil Bhartiya Parivar Party,1479,4,1483,S0431
6567,ANIL DAS,Bhartiya Dalit Party,1465,4,1469,S0431
6568,ANIL KUMAR CHAND,Socialist Unity Centre Of India (COMMUNIST),1421,3,1424,S0431
6569,MADHURI KUMARI,All India Forward Bloc,1301,1,1302,S0431
6570,JAWAHAR SINGH,Bhartiya Manavta Party,1235,2,1237,S0431
6571,NOTA,None of the Above,5573,33,5606,S0431
6572,Shyamkumar (Babalu) Daulat Barve,Indian National Congress,611894,1131,613025,S139
6573,RAJU DEONATH PARVE,Shiv Sena,535234,1023,536257,S139
6574,SANDIP SAHADEO MESHRAM,Bahujan Samaj Party,26003,95,26098,S139
6575,KISHORE  UTTAMRAO GAJBHIYE,Independent,24324,59,24383,S139
6576,AJAY BAKARAM CHAVAN,Independent,6021,5,6026,S139
6577,SANVIDHAN G LOKHANDE,Baliraja Party,5810,4,5814,S139
6578,ROSHANI ATUL GAJBHIYE,Gondvana Gantantra Party,5108,29,5137,S139
6579,GOWARDHAN DEORAO KUMBHARE,Viro Ke Vir Indian Party,3750,16,3766,S139
6580,ARVIND SHIVAJI TANDEKAR,Independent,3208,7,3215,S139
6581,SANJAY VASANTRAO BORKAR,Maharashtra Vikas Aghadi,1983,9,1992,S139
6582,SHANKAR CHINTAMAN CHAHANDE,Vanchit Bahujan  Aaghadi,1858,26,1884,S139
6583,ADV BHIMRAO SHENDE,Bahujan Republican  Socialist Party,1811,7,1818,S139
6584,GAIKWAD MANJUSHA SACHIN,Akhil Bhartiya Parivar Party,1760,13,1773,S139
6585,ASHISH BHAURAO SARODE,Bhim Sena,1600,20,1620,S139
6586,PRAMOD SHRIPAT KHOBRAGADE,Ambedkarite Party of India,1337,3,1340,S139
6587,UMESH RAJU  KHADSE,Rashtra Samarpan Party,1223,6,1229,S139
6588,SIDDHARTH GADIJI PATIL,Peoples Party of India (Democratic),975,2,977,S139
6589,PREMKUMAR DASHRATH GAJBHARE,Independent,921,4,925,S139
6590,RIDDHESHWAR ANANDRAO BELEY,Republican Party of India (A),908,5,913,S139
6591,BHOJRAJ TUKARAM SARODE,Jay Vidarbha Party,881,7,888,S139
6592,VILAS SHRIPAT KHADSE,Independent,857,3,860,S139
6593,SUBHASH LOKHANDE,Independent,849,1,850,S139
6594,KARTIK GENDLALJI DOKE,Independent,844,3,847,S139
6595,ADV ULHAS SHALIKRAM DUPARE,Independent,780,1,781,S139
6596,LAROKAR SURESH PUNDLIK,Independent,693,5,698,S139
6597,SUNIL UTTAMRAO SALVE,Independent,649,2,651,S139
6598,GOWARDHAN NAMDEO SOMDEVE,Independent,509,2,511,S139
6599,VILAS GANESH ZODAPE,Independent,402,5,407,S139
6600,NOTA,None of the Above,7769,58,7827,S139
6601,BALASHOWRY VALLABHANENI,Janasena Party,712149,12290,724439,S0111
6602,SIMHADRI CHANDRA SEKHAR RAO,Yuvajana Sramika Rythu Congress Party,495211,6049,501260,S0111
6603,GOLLU KRISHNA,Indian National Congress,31130,695,31825,S0111
6604,BAAL SHOURI CHODABATHINA,Jatiya Jana Sena Party,10518,623,11141,S0111
6605,DEVAMANI DEVARAPALLI,Bahujan Samaj Party,9911,117,10028,S0111
6606,KOMMARAJU SIVA NARASIMHA RAO,All India Forward Bloc,5245,9,5254,S0111
6607,VALLABHANENI NAGA PAVAN KUMAR,Independent,5206,14,5220,S0111
6608,MARADANI K R SWAMY,Jai Maha Bharath Party,2206,8,2214,S0111
6609,GANDHI  DHANEKULA,Independent,1989,2,1991,S0111
6610,PAMULA BALA SOWRYAMMA,Independent,1576,6,1582,S0111
6611,ANUSHA YERUVA,Independent,1233,2,1235,S0111
6612,GUDAVALLI VENKATA KEDARESWARA RAO,Independent,1102,9,1111,S0111
6613,JOGI VEERANJANEYULU,Independent,1020,2,1022,S0111
6614,DAMODARA RAO GUDAVALLI,Independent,928,2,930,S0111
6615,APPARAO ENNETI,Independent,625,1,626,S0111
6616,NOTA,None of the Above,12008,118,12126,S0111
6617,SHANKAR LALWANI,Bharatiya Janata Party,1223746,3005,1226751,S1226
6618,SANJAY S/O LAKSHMAN SOLANKI,Bahujan Samaj Party,51486,173,51659,S1226
6619,PAWAN KUMAR,Akhil Bhartiya Parivar Party,15182,28,15210,S1226
6620,ABHAY JAIN,Independent,8379,13,8392,S1226
6621,LAVISH DILIP KHANDELWAL,Independent,8231,7,8238,S1226
6622,COMRADE AJEET SINGH,Socialist Unity Centre Of India (COMMUNIST),7148,31,7179,S1226
6623,AYAZ ALI,Independent,7074,22,7096,S1226
6624,ENG. ARJUN PARIHAR,Independent,3823,8,3831,S1226
6625,BASANT GEHLOT,Jan Sangh Party,3663,13,3676,S1226
6626,RAVI SIRWAIYA,Independent,2615,6,2621,S1226
6627,MUDIT CHAURASIA,Independent,2601,8,2609,S1226
6628,PARMANAND TOLANI,Independent,2399,4,2403,S1226
6629,DESH BHAKT ANKIT GUPTA,Independent,1957,12,1969,S1226
6630,ADVOCATE PANKAJ GUPTE,Independent,1652,8,1660,S1226
6631,NOTA,None of the Above,218355,319,218674,S1226
6632,HANUMAN BENIWAL,Rashtriya Loktantrik Party,591460,5495,596955,S2014
6633,JYOTI MIRDHA,Bharatiya Janata Party,550304,4426,554730,S2014
6634,DR ASHOK CHOUDHARY,Abhinav Rajasthan Party,26251,43,26294,S2014
6635,DR. GAJENDRA SINGH RATHORE,Bahujan Samaj Party,23551,457,24008,S2014
6636,RAJKUMAR JAT,Independent,8219,13,8232,S2014
6637,HARI RAM,Independent,7610,16,7626,S2014
6638,PREMRAJ KHARDIYA,Independent,4504,8,4512,S2014
6639,AMEEN KHAN,Independent,4439,24,4463,S2014
6640,HANUMAN SINGH KALVI,Rashtriya Janshakti Party (Secular),2862,20,2882,S2014
6641,NOTA,None of the Above,8711,60,8771,S2014
6642,DURGADAS (D. D.) UIKEY,Bharatiya Janata Party,846696,1540,848236,S1229
6643,RAMU TEKAM,Indian National Congress,467810,665,468475,S1229
6644,ARJUN ASHOK BHALAVI,Bahujan Samaj Party,26559,38,26597,S1229
6645,ANIL UIKEY,Bharat Adivasi Party,10552,24,10576,S1229
6646,BHURELAL CHOTELAL BETHEKAR,Independent,7800,11,7811,S1229
6647,BHAGCHARAN WARKADE,Independent,5957,11,5968,S1229
6648,SUNER UIKEY,Gondvana Gantantra Party,4172,14,4186,S1229
6649,BARSKAR SUBHASH KORAKU,Swatantra Kisan Party,3831,18,3849,S1229
6650,NOTA,None of the Above,20309,13,20322,S1229
6651,PHANI BHUSAN CHOUDHURY,Asom Gana Parishad,853642,6471,860113,S033
6652,DEEP BAYAN,Indian National Congress,635411,2351,637762,S033
6653,MANORANJAN TALUKDAR,Communist Party of India  (Marxist),95020,1118,96138,S033
6654,ABUL KALAM AZAD,All India Trinamool Congress,16359,73,16432,S033
6655,DEWAN MOHIBUL ISLAM,Independent,9930,11,9941,S033
6656,SAMEJ UDDIN,Bodoland Peoples Front,9515,177,9692,S033
6657,DULU AHMED,Independent,9275,63,9338,S033
6658,MATIAR RAHMAN,Independent,7920,15,7935,S033
6659,JAGANNATH RAY,Independent,5474,74,5548,S033
6660,SHAJAHAN ALI KHAN,Voters Party  International,4441,7,4448,S033
6661,AYNAL HAQUE,Independent,3174,18,3192,S033
6662,CHITRALEKHA DAS,Socialist Unity Centre Of India (COMMUNIST),3060,71,3131,S033
6663,AMZAD ALI,Republican Party of India (Athawale),2657,22,2679,S033
6664,ABUBAKKAR SIDDIQUE,Rashtriya Ulama Council,2463,14,2477,S033
6665,NOTA,None of the Above,16888,229,17117,S033
6666,BRIJMOHAN AGRAWAL,Bharatiya Janata Party,1047447,2904,1050351,S268
6667,VIKAS UPADHYAY,Indian National Congress,473656,1410,475066,S268
6668,MAMTA RANI SAHU,Bahujan Samaj Party,9201,98,9299,S268
6669,SAVITA SHAILENDRA BANJARE,Shakti Sena (Bharat Desh),8765,3,8768,S268
6670,RADHESHWARI GAIKWAD,Independent,4629,1,4630,S268
6671,SURESH KUMAR NETAM,Hamar Raj Party,3492,7,3499,S268
6672,ANIL MAHOBIA,Right to Recall Party,2914,2,2916,S268
6673,ENGI. LAL BAHADUR YADAV,Gondvana Gantantra Party,2859,6,2865,S268
6674,RAMKRISHNA VERMA,Independent,2182,3,2185,S268
6675,YAKUB KHAN,Independent,2054,0,2054,S268
6676,VISHWAJIT HARODE,Socialist Unity Centre Of India (COMMUNIST),1920,0,1920,S268
6677,AMARNATH CHANDRAKAR,Independent,1608,0,1608,S268
6678,LAKHAMOO RAM TANDON,Rashtriya Jansabha Party,1347,4,1351,S268
6679,YASHUTOSH LAHARE,Ambedkarite Party of India,1312,0,1312,S268
6680,RAJESH DHRUV,Independent,1187,6,1193,S268
6681,BODHAN LAL FARIKAR,Independent,1059,0,1059,S268
6682,DAYA SHANKER NISHAD,Bhartiya Shakti Chetna Party,1051,11,1062,S268
6683,PILARAM ANANT,Sunder Samaj Party,1033,3,1036,S268
6684,ROHIT KUMAR PATIL,Independent,960,0,960,S268
6685,HIRA NAND NAGWANI (ASHOK BHAIYA),Republican Party of India (A),958,2,960,S268
6686,BHANJAN JANGADE (ADHIWAKTA),Bharatiya Bahujan Congress,818,3,821,S268
6687,MO. AMIN,Bhrashtachar Mukti Morcha,765,1,766,S268
6688,MANOJ VERMA,Independent,723,1,724,S268
6689,PITAMBAR JANGDE,Aazad Samaj Party (Kanshi Ram),701,4,705,S268
6690,ASHISH KUMAR TIWARI,Aap Sabki Apni Party,525,3,528,S268
6691,ENGI. BHANU PRATAP TANDE,Independent,500,3,503,S268
6692,MO. IMRAN KHAN,Independent,466,1,467,S268
6693,NEERAJ SAINI PUJARI,Dhoom Sena,434,0,434,S268
6694,SUDHANSHU BHUSHAN,Independent,413,1,414,S268
6695,RAMPRASAD PRAJAPATI,Independent,391,0,391,S268
6696,PRAVIN JAIN,Independent,369,0,369,S268
6697,VINAYAK DHAMGAYE,Independent,349,0,349,S268
6698,NANDNI NAYAK,Independent,336,1,337,S268
6699,PRAVISHANT SALOMAN,Independent,310,0,310,S268
6700,SAYED IRSHAD,Independent,295,0,295,S268
6701,DR. OMPRAKASH SAHU,Independent,291,3,294,S268
6702,MO. NASIR,Independent,254,0,254,S268
6703,NURI KHAN,Independent,252,0,252,S268
6704,NOTA,None of the Above,4414,34,4448,S268
6705,RAM PRASAD CHAUDHARY,Samajwadi Party,523487,3518,527005,S2461
6706,HARISH CHANDRA ALIAS HARISH DWIVEDI,Bharatiya Janata Party,424604,1407,426011,S2461
6707,LAVKUSH PATEL,Bahujan Samaj Party,102818,483,103301,S2461
6708,PANKAJ DUBEY,Log Party,4624,3,4627,S2461
6709,PREM KUMAR,Moulik Adhikar Party,3607,4,3611,S2461
6710,HAFIZ ALI,All India Forward Bloc,2985,3,2988,S2461
6711,RAM KARAN GAUTAM,Independent,2640,5,2645,S2461
6712,PRAMOD KUMAR,Independent,2554,3,2557,S2461
6713,SHAILENDRA KUMAR,Bharat Mahaparivar Party,2361,3,2364,S2461
6714,NOTA,None of the Above,7742,19,7761,S2461
6715,SHIVMANGAL SINGH TOMAR,Bharatiya Janata Party,513136,2341,515477,S121
6716,NEETU SATYAPAL SINGH SIKARWAR,Indian National Congress,461808,1139,462947,S121
6717,RAMESH GARG,Bahujan Samaj Party,179492,177,179669,S121
6718,NEERAJ CHANDSORIYA,Aazad Samaj Party (Kanshi Ram),7534,10,7544,S121
6719,RAJENDRA PRASAD KUSHWAH,Independent,2392,10,2402,S121
6720,ER. SURAJ KUSHWAH,Independent,2279,6,2285,S121
6721,RAMNIWASH,Independent,1970,3,1973,S121
6722,RAM SUNDER SHARMA,Independent,1762,5,1767,S121
6723,RAMSEVAK SAKHWAR,Independent,1630,2,1632,S121
6724,HARIKANTH,Independent,1623,0,1623,S121
6725,RAJKUMARI,Independent,1435,6,1441,S121
6726,ANOOP NAGAR,Independent,1308,9,1317,S121
6727,RAJENDRA SINGH GURJER,Independent,1199,11,1210,S121
6728,PIYUSH BRAJESH RAJORIYA,Independent,572,3,575,S121
6729,PRABHU JATAV,Independent,547,8,555,S121
6730,NOTA,None of the Above,4899,15,4914,S121
6731,AGA SYED RUHULLAH MEHDI,Jammu & Kashmir National Conference,355294,1572,356866,U082
6732,WAHEED UR REHMAN PARA,Jammu & Kashmir Peoples Democratic Party,167666,784,168450,U082
6733,MOHAMMAD ASHRAF MIR,Jammu and Kashmir Apni Party,65494,460,65954,U082
6734,AMIR AHMAD BHAT,Democratic Progressive Azad Party,15061,43,15104,U082
6735,SHEEBAN ASHAI,Independent,13063,8,13071,U082
6736,SAYIM MUSTAFA,Independent,8831,49,8880,U082
6737,JIBRAN FIRDOUS DAR,Independent,5431,67,5498,U082
6738,JAHANGIR AHMAD SHEIKH,Independent,4412,10,4422,U082
6739,SAJAD AHMAD DAR,Independent,3755,9,3764,U082
6740,HAKIKAT SINGH,Jammu & Kashmir National Panthers Party (Bhim),3732,46,3778,U082
6741,RUBINA AKHTER,National Loktantrik Party,2855,21,2876,U082
6742,WASEEM HASSAN SHEIKH,Independent,2838,17,2855,U082
6743,RIYAZ AHMAD BHAT,Independent,2791,1,2792,U082
6744,FAYAZ AHMAD BUTT,Independent,2221,6,2227,U082
6745,SHAHNAZ HUSSAIN SHAH,Independent,2196,7,2203,U082
6746,MOHD YOUSUF BHAT,Gana Suraksha Party,1880,18,1898,U082
6747,WAHEEDA TABASUM SHAH,Independent,1594,12,1606,U082
6748,NISAR AHMAD AHANGAR,Independent,1115,9,1124,U082
6749,MIRZA SAJAD HUSSAIN BEIGH,Independent,1049,15,1064,U082
6750,GHULAM MOHAMMAD WANI,Independent,1028,12,1040,U082
6751,AMIN DAR,Independent,989,7,996,U082
6752,JAVEED AHMAD WANI,Independent,928,4,932,U082
6753,YOUNIS AHMAD MIR,Bharat Jodo Party,913,12,925,U082
6754,DR QAZI ASHRAF,Independent,910,9,919,U082
6755,NOTA,None of the Above,5887,111,5998,U082
6756,GURUMOORTHY MADDILA,Yuvajana Sramika Rythu Congress Party,626702,5526,632228,S0123
6757,VARA PRASAD RAO VELAGAPALLI,Bharatiya Janata Party,608494,9165,617659,S0123
6758,CHINTA MOHAN,Indian National Congress,63790,1733,65523,S0123
6759,PENUMURU. GURAPPA,Bahujan Samaj Party,10300,206,10506,S0123
6760,KATTAMANCHI. PRABHAKAR,Independent,5796,6,5802,S0123
6761,M UMADEVI,Janata Congress,5387,38,5425,S0123
6762,ALLAM.RAJA,Independent,4948,22,4970,S0123
6763,VIJAY KUMAR G.SRKR,Liberation Congress Party,4108,194,4302,S0123
6764,ANJAIAH.P,Republican Party of India (A),3657,9,3666,S0123
6765,V.C. NAVEEN GUPTA,Independent,1723,8,1731,S0123
6766,A. VARAPRASAD,Jatiya Jana Sena Party,1668,30,1698,S0123
6767,SYAMDHAN KURAPATI,Aihra National Party,1567,1,1568,S0123
6768,C. PUNYAMURTHY,United Republican Party of India,1511,4,1515,S0123
6769,KARRA SIVA,Pyramid Party of India,1501,9,1510,S0123
6770,VELURU. THEJOVATHI,Samajwadi Party,1362,27,1389,S0123
6771,C. DAVID,Indian Believers Party (IBP),1237,2,1239,S0123
6772,K. JEEVARATHNAM,Independent,1203,1,1204,S0123
6773,DASARI. GOWTHAM,Independent,1077,10,1087,S0123
6774,VIJAYA KUMAR.G,Independent,797,4,801,S0123
6775,A. MADHU,Jai Hindustan Party,711,0,711,S0123
6776,B. BHARANI BAS,Ambedkar National Congress,688,0,688,S0123
6777,Y. MAHESH,Independent,615,7,622,S0123
6778,PRASAD PATIBANDLA,Independent,607,1,608,S0123
6779,NOTA,None of the Above,15909,209,16118,S0123
6780,M. MALLESH BABU,Janata Dal  (Secular),689185,2296,691481,S1028
6781,K V GOWTHAM,Indian National Congress,618700,1393,620093,S1028
6782,SUMAN H N,Independent,6484,3,6487,S1028
6783,HOLUR SRINIVASA,Independent,6159,4,6163,S1028
6784,S B SURESHA,Bahujan Samaj Party,4688,44,4732,S1028
6785,K R DEVARAJA,Delhi Janta Party,4588,9,4597,S1028
6786,DR M. VENKATASWAMY,Independent,3336,18,3354,S1028
6787,R RANJITHKUMAR,Independent,2116,2,2118,S1028
6788,S N NARAYANASWAMY V,Independent,1971,14,1985,S1028
6789,D GOPALAKRISHNA,Socialist Party (India),1661,8,1669,S1028
6790,DEVARAJA A ALUSURUDINNE,Uttama Prajaakeeya Party,1343,11,1354,S1028
6791,M S BADARINARAYANA,Independent,1104,12,1116,S1028
6792,MAHESH A V,Karnataka Rashtra Samithi,1035,30,1065,S1028
6793,THIMMARAYAPPA,Republican Party of India (Karnataka),856,8,864,S1028
6794,R RAJENDRA,Independent,750,1,751,S1028
6795,M MUNIGANGAPPA,Independent,595,9,604,S1028
6796,M  C HALLI VENU,Viduthalai Chiruthaigal Katchi,514,7,521,S1028
6797,KRISHNAIAH N,Independent,438,5,443,S1028
6798,NOTA,None of the Above,5798,33,5831,S1028
6799,GAIKWAD VARSHA EKNATH,Indian National Congress,444098,1447,445545,S1329
6800,ADV UJWAL NIKAM,Bharatiya Janata Party,427387,1644,429031,S1329
6801,SANTOSH GANPAT AMBULGE,Vanchit Bahujan  Aaghadi,8233,55,8288,S1329
6802,AYYUB AMIN HUNGUND,Bahujan Samaj Party,3229,14,3243,S1329
6803,ANSON THOMAS,People's Party of India(secular),2207,4,2211,S1329
6804,RAMZAN ALI CHAUDHARY,All India Majlis-E-Ittehadul Muslimeen,1521,10,1531,S1329
6805,AJAZ MOHAMMAD SAFI KHAN,Independent,1041,0,1041,S1329
6806,HAYATULAH ABDULAH SHAIKH,Akhil Bharatiya Muslim League (Secular),818,3,821,S1329
6807,NAZMAKHATHUN MOHAMMED ZAFAR KHAN,Independent,730,2,732,S1329
6808,SHANTARAM S DIGHE,Independent,723,10,733,S1329
6809,NARENDRA MISHRA,Independent,706,2,708,S1329
6810,ADV ASIF ALI SIDDIQUIE,Independent,681,2,683,S1329
6811,HARSHADA BABURAV JADHAV,Maharashtra Vikas Aghadi,673,17,690,S1329
6812,RAMA ARUN SABLE,Independent,626,10,636,S1329
6813,SANDEEP BHAU RAMCHANDRA JADHAV,Independent,619,4,623,S1329
6814,DR GAFFAR IBRAHIM SAYED,Independent,584,2,586,S1329
6815,ADV UTTAMKUMAR NAKUL SAJANI SAHU,Independent,554,4,558,S1329
6816,KHAN ABBAS AHMED,Bahujan Maha Party,427,1,428,S1329
6817,MUSHTAQUE HAIDER SHAIKH,Independent,405,0,405,S1329
6818,DR ADV YASHWANT RAMBHAU KASBE,Bhartiya Jan Vikas Aaghadi,385,6,391,S1329
6819,KURBAN SHAHADAT HUSAIN,Rashtriya Ulama Council,366,1,367,S1329
6820,ABDUL TAHIR ADVOCATE BABLU RAJNIKANT,Independent,355,0,355,S1329
6821,SHAUKAT ABDUL RAFIQ KHAN,Insaniyat Party,341,4,345,S1329
6822,RAJESH MOHAN LOKHANDE,Independent,282,7,289,S1329
6823,YUNUSALI RASHID MULLA,Independent,220,0,220,S1329
6824,ADV FEROZ SHAIKH,Independent,180,0,180,S1329
6825,MUZAFAR ALI SHAIKH,Independent,173,0,173,S1329
6826,NOTA,None of the Above,9665,84,9749,S1329
6827,PATHAN YUSUF,All India Trinamool Congress,523630,886,524516,S2510
6828,ADHIR RANJAN CHOWDHURY,Indian National Congress,438171,1323,439494,S2510
6829,DR. NIRMAL KUMAR SAHA,Bharatiya Janata Party,370370,1515,371885,S2510
6830,SAMIRAN DAS,Independent,18526,1,18527,S2510
6831,SWAPAN KUMAR MANDAL,Independent,6394,2,6396,S2510
6832,SANTOSH BISWAS,Bahujan Samaj Party,4219,19,4238,S2510
6833,BISWAMVOIR KALITA,Independent,3060,2,3062,S2510
6834,SOMNATH PAUL,All India Arya Mahasabha,2250,0,2250,S2510
6835,RUNA LAILA,Social Democratic Party Of India,1569,2,1571,S2510
6836,ABHIJIT MANDAL,Socialist Unity Centre Of India (COMMUNIST),1410,8,1418,S2510
6837,ASHIS DAS,Independent,1106,4,1110,S2510
6838,ADHIR SWARNAKAR,Independent,851,5,856,S2510
6839,AJIT KUMAR MANDAL,Independent,745,4,749,S2510
6840,MANIK KUMAR DAS,Jai Prakash Janata Dal,729,0,729,S2510
6841,AABDUSA SATTAR SEKH,Indian National Socialistic Action Forces,477,7,484,S2510
6842,NOTA,None of the Above,7474,11,7485,S2510
6843,LOVELY ANAND,Janata Dal  (United),475709,903,476612,S044
6844,RITU JAISWAL,Rashtriya Janata Dal,445482,1987,447469,S044
6845,AKHILESHWAR SHRIVAISHANV,Independent,29014,80,29094,S044
6846,KANHAIYA KUMAR,Independent,20585,7,20592,S044
6847,RANA RANJIT,All India Majlis-E-Ittehadul Muslimeen,11947,32,11979,S044
6848,SUDHIR KUMAR SINGH,Viro Ke Vir Indian Party,9096,6,9102,S044
6849,VIJENDRA THAKUR,Bahujan Samaj Party,8865,23,8888,S044
6850,UPENDRA SAHANI,Rashtriya Jansambhavna Party,6332,6,6338,S044
6851,MAMTA KUMARI,Samata Party,5431,4,5435,S044
6852,MOHAMMAD MAHTAB ALAM,Samaj Shakti Party,4867,4,4871,S044
6853,JAGDISH PRASAD,Bajjikanchal Vikas Party,2950,5,2955,S044
6854,DILIP KUMAR MISHRA,Prabal Bharat Party,2097,2,2099,S044
6855,NOTA,None of the Above,30130,38,30168,S044
6856,TATKARE SUNIL DATTATREY,Nationalist Congress Party,506529,1823,508352,S1332
6857,ANANT GEETE,Shiv Sena (Uddhav Balasaheb Thackrey),423137,2431,425568,S1332
6858,KUMUDINI RAVINDRA CHAVAN,Vanchit Bahujan  Aaghadi,19500,118,19618,S1332
6859,SHRINIVAS SATYANARAYAN MATTAPARTI,Independent,9379,15,9394,S1332
6860,AMIT SHRIPAL KAWADE,Independent,5603,31,5634,S1332
6861,ANANT BALOJI GITE,Independent,3485,30,3515,S1332
6862,NITIN JAGANNATH MAYEKAR,Independent,2548,12,2560,S1332
6863,CHAULE PANDURANG DAMODAR,Independent,2394,23,2417,S1332
6864,ANANT PADMA GITE,Independent,2001,39,2040,S1332
6865,COL PRAKASHRAO CHAVAN,Bharatheeya Jawan Kisan Party,1863,76,1939,S1332
6866,KOLI MANGESH PADMAKAR,Independent,1797,23,1820,S1332
6867,ADV AJAY UPADHYE,Independent,1756,39,1795,S1332
6868,ANJANI ASHWIN KELKAR,Independent,1325,25,1350,S1332
6869,NOTA,None of the Above,27188,82,27270,S1332
6870,KALYAN BANERJEE,All India Trinamool Congress,671865,2105,673970,S2527
6871,KABIR SHANKAR BOSE,Bharatiya Janata Party,497720,1420,499140,S2527
6872,DIPSITA DHAR,Communist Party of India  (Marxist),238131,1015,239146,S2527
6873,SAHARIAR MULLICK (BAPI),All India Secular Front,25659,18,25677,S2527
6874,SUNDAR PATRA,Independent,9897,5,9902,S2527
6875,SASANKA CHAKRABORTY,Independent,3933,5,3938,S2527
6876,SUPRIYA BISWAS,Bahujan Samaj Party,3572,17,3589,S2527
6877,KALYAN PAUL,Independent,1749,9,1758,S2527
6878,PRADYUT CHOWDHURI,Socialist Unity Centre Of India (COMMUNIST),1671,9,1680,S2527
6879,KALYAN SAMANTA,Independent,1421,19,1440,S2527
6880,SARKAR MANGAL,Bahujan Maha Party,1256,2,1258,S2527
6881,NOTA,None of the Above,14964,70,15034,S2527
6882,VE VAITHILINGAM,Indian National Congress,424292,1713,426005,U071
6883,A NAMASSIVAYAM,Bharatiya Janata Party,288050,1439,289489,U071
6884,R MENAGA,Naam Tamilar Katchi,39545,58,39603,U071
6885,G THAMIZHVENDAN,All India Anna Dravida Munnetra Kazhagam,25059,106,25165,U071
6886,P SANKARAN,Socialist Unity Centre Of India (COMMUNIST),2057,9,2066,U071
6887,ARADADI POSIYYA,Independent,1540,6,1546,U071
6888,D ALANGARAVELU,Bahujan Samaj Party,1534,6,1540,U071
6889,K KISHORKUMAR,Independent,1240,6,1246,U071
6890,KOLLANJIAPPAN,Independent,1198,1,1199,U071
6891,M MANIKANDAN,Independent,1130,3,1133,U071
6892,M KRISHNAMURTHY,Independent,1052,19,1071,U071
6893,K PRABHU DEVAN,United Republican Party of India,981,8,989,U071
6894,S BAKTHAVATCHALAM,Independent,923,1,924,U071
6895,S SATHISH KUMAR,Independent,842,4,846,U071
6896,COUTTANE ALIAS DHIVANEEDHE,Independent,819,3,822,U071
6897,E ANANTHAVEL,Independent,771,5,776,U071
6898,S KALA,Independent,593,33,626,U071
6899,P RAJAN,Independent,545,2,547,U071
6900,NIRMALA G,Independent,474,1,475,U071
6901,K ARUNACHALAM,Independent,403,2,405,U071
6902,K RAMADASS,Independent,368,4,372,U071
6903,R RAJA,Independent,326,5,331,U071
6904,D RAVINDIRAN,Independent,305,2,307,U071
6905,S MASCO,Independent,248,6,254,U071
6906,V P MANICKAM,Independent,242,2,244,U071
6907,M MURUGAN,Independent,196,0,196,U071
6908,NOTA,None of the Above,9756,7,9763,U071
6909,SANJAY DINA PATIL,Shiv Sena (Uddhav Balasaheb Thackrey),448604,2333,450937,S1328
6910,MIHIR CHANDRAKANT KOTECHA,Bharatiya Janata Party,419589,1487,421076,S1328
6911,DAULAT KADAR KHAN,Vanchit Bahujan  Aaghadi,14571,86,14657,S1328
6912,NANDESH VITHAL UMAP,Bahujan Samaj Party,8217,101,8318,S1328
6913,DR. SUSHMA MAURYA,Independent,2886,5,2891,S1328
6914,SANJAY B. PATIL,National People's Party,2757,7,2764,S1328
6915,SANJU MARUTI PAWAR,Maharashtra Vikas Aghadi,2555,27,2582,S1328
6916,PROF. DR. PRASHANT GANGAWANE,Desh Janhit Party,2338,35,2373,S1328
6917,PREM RAMAPATI GUPTA,Independent,1598,3,1601,S1328
6918,MOHAMMED AHMED SHAIKH,Independent,1289,5,1294,S1328
6919,MOHAMMAD ARMAN MOHAMMAD WASI KHAN,Rashtriya Janhit Sangharsh Party,1085,5,1090,S1328
6920,VIDYA NAIK,Independent,974,5,979,S1328
6921,BHOPINDER SINGH SAINI,Viro Ke Vir Indian Party,941,5,946,S1328
6922,BANSODE DILIP,Independent,831,7,838,S1328
6923,BHAWANI H. CHOUDHARY,Sardar Vallabhbhai Patel Party,742,4,746,S1328
6924,DATTATRAY ARJUN UTEKAR,Bharatheeya Jawan Kisan Party,707,4,711,S1328
6925,COMRADE SURENDRA SIBAG,All India Forward Bloc,675,3,678,S1328
6926,SHAHAJI  NANAI THORAT,Independent,648,2,650,S1328
6927,SANJAY SAOJI DESHPANDE,Republican Party of India,641,0,641,S1328
6928,SANJAY PATIL,Independent,520,4,524,S1328
6929,NOTA,None of the Above,10088,85,10173,S1328
6930,DR. SHARMILA SARKAR,All India Trinamool Congress,717881,2421,720302,S2538
6931,ASIM KUMAR SARKAR,Bharatiya Janata Party,557943,1787,559730,S2538
6932,NIRAB KHAN,Communist Party of India  (Marxist),176358,541,176899,S2538
6933,NIRMAL MAJHI,Socialist Unity Centre Of India (COMMUNIST),10964,12,10976,S2538
6934,MUKUL BISWAS,Bahujan Samaj Party,7610,21,7631,S2538
6935,SHARMILA SARKAR,Independent,4875,18,4893,S2538
6936,SAJAL KUMAR DE,Communist Party of India  (Marxist-Leninist)  (Liberation),4163,19,4182,S2538
6937,NOTA,None of the Above,12654,43,12697,S2538
6938,K E PRAKASH,Dravida Munnetra Kazhagam,558849,3490,562339,S2217
6939,ASHOK KUMAR,All India Anna Dravida Munnetra Kazhagam,323751,2022,325773,S2217
6940,KARMEGAN M,Naam Tamilar Katchi,82332,464,82796,S2217
6941,P VIJAYAKUMAR,Tamil Maanila Congress  (Moopanar),77319,592,77911,S2217
6942,P ESWARAN,Bahujan Samaj Party,5161,62,5223,S2217
6943,T V R AMIRTHALINGAM,Independent,4118,31,4149,S2217
6944,KEERTHANA M,Independent,3775,24,3799,S2217
6945,J GOPALAKRISHNAN,Independent,1949,6,1955,S2217
6946,S ANANTHI,Independent,1683,3,1686,S2217
6947,PRASATH CHITRARASU,Independent,1629,11,1640,S2217
6948,RAVICHANDRAN L,Independent,1378,2,1380,S2217
6949,P RAJENDRAN,Independent,973,3,976,S2217
6950,P KUPPUSAMY,Ulzaipali Makkal Katchy,945,5,950,S2217
6951,M SHANMUGAM,Independent,768,4,772,S2217
6952,R KUMARESAN,Independent,744,7,751,S2217
6953,N ASHOK KUMAR,Independent,689,1,690,S2217
6954,DHANALAKSHMI V,Naadaalum Makkal Katchi,675,4,679,S2217
6955,A T MUNUSAMY,Samaniya Makkal Nala Katchi,611,5,616,S2217
6956,K MAATHAN,Ganasangam Party of India,609,9,618,S2217
6957,B DHARMARAJ,Anti Corruption Dynamic Party,597,4,601,S2217
6958,ARUMUGA AC KANNAN,Independent,547,2,549,S2217
6959,M SABARINATHAN,Independent,525,6,531,S2217
6960,R DHANDAPANI,Veerath Thiyagi Viswanathadoss Thozhilalarkal Katchi,502,2,504,S2217
6961,R KUMAR,Anna Puratchi Thalaivar Amma Dravida Munnetra Kazhagam,424,8,432,S2217
6962,R.MINNALMURUGESH,Independent,413,2,415,S2217
6963,K K VADUGANATHAN,Independent,398,1,399,S2217
6964,G MYLSAMY,Independent,301,0,301,S2217
6965,MYLVAKANAN D -,Independent,276,3,279,S2217
6966,M PRABAKARAN,Independent,274,2,276,S2217
6967,NARENDRANATH,Independent,272,0,272,S2217
6968,K SENTHIL KUMAR,Independent,177,1,178,S2217
6969,NOTA,None of the Above,13742,241,13983,S2217
6970,DHARMENDRA YADAV,Samajwadi Party,504837,3402,508239,S2469
6971,DINESH LAL YADAV “NIRAHUA”,Bharatiya Janata Party,345725,1479,347204,S2469
6972,MASHHOD SABEEHA ANSARI,Bahujan Samaj Party,179189,650,179839,S2469
6973,RAVINDRA NATH SHARMA,Moulik Adhikar Party,3038,4,3042,S2469
6974,PARAS YADAV,Jan Raajya Party,2489,2,2491,S2469
6975,SHASHIDHAR,Independent,2227,5,2232,S2469
6976,MAHENDRA NATH YADAV,Moolniwasi Samaj Party,1904,1,1905,S2469
6977,VIJAY KUMAR,Independent,1733,2,1735,S2469
6978,PANKAJ KUMAR YADAV,Independent,1595,4,1599,S2469
6979,NOTA,None of the Above,6211,23,6234,S2469
6980,BHAGIRATH CHOUDHARY,Bharatiya Janata Party,741151,6311,747462,S2013
6981,RAMCHANDRA CHOUDHARY,Indian National Congress,413685,3786,417471,S2013
6982,RAMDEV,Bahujan Samaj Party,4896,48,4944,S2013
6983,SURENDRA SINGH RANAVAT,Independent,4348,25,4373,S2013
6984,MUKESH GENA,Bharatiya Yuva Jan Ekta Party,3187,9,3196,S2013
6985,JITENDRA BOYAT,Aazad Samaj Party (Kanshi Ram),2608,25,2633,S2013
6986,SATYANARAYAN MALI,Independent,2409,11,2420,S2013
6987,VISHRAM BABU,Independent,1517,7,1524,S2013
6988,SHABUDADIN,National Future Party,1190,7,1197,S2013
6989,YUSUF,Independent,988,12,1000,S2013
6990,PREM LATA,Independent,988,167,1155,S2013
6991,BHAWARLAL SONI,Independent,868,70,938,S2013
6992,RAMLAL,Akhil Bhartiya Aamjan Party,807,11,818,S2013
6993,DAYA MOHAN GARG,Independent,644,2,646,S2013
6994,NOTA,None of the Above,11290,112,11402,S2013
6995,AMRITPAL SINGH,Independent,402600,1830,404430,S193
6996,KULBIR SINGH ZIRA,Indian National Congress,206286,1024,207310,S193
6997,LALJIT SINGH BHULLAR,Aam Aadmi Party,194160,676,194836,S193
6998,VIRSA SINGH VALTOHA,Shiromani Akali Dal,86291,125,86416,S193
6999,MANJIT SINGH MANNA,Bharatiya Janata Party,85810,563,86373,S193
7000,PARAMJIT SINGH,Independent,12522,3,12525,S193
7001,CHAIN SINGH BAINKA,Aas Punjab Party,6728,11,6739,S193
7002,SATNAM SINGH,Bahujan Samaj Party,5021,45,5066,S193
7003,SARABJIT SINGH,Independent,4835,1,4836,S193
7004,GURDIAL SINGH,Communist Party of India,3945,7,3952,S193
7005,ANOKH SINGH KATWAL,Independent,2766,3,2769,S193
7006,GURPREET SINGH,Independent,2609,0,2609,S193
7007,AJIT SINGH,Independent,2528,7,2535,S193
7008,ARUN KUMAR,Independent,2522,3,2525,S193
7009,SURJIT SINGH BHIKHIWIND,Independent,2367,4,2371,S193
7010,KAWALJIT SINGH,Independent,2290,4,2294,S193
7011,HARJINDER SINGH,Independent,1969,1,1970,S193
7012,KANWALJIT SINGH,Independent,1895,6,1901,S193
7013,PARMINDER SINGH,Independent,1802,1,1803,S193
7014,JASWANT SINGH SOHAL,Independent,1637,2,1639,S193
7015,LAKHBIR SINGH,Independent,1420,1,1421,S193
7016,VIKRAMJIT SINGH,Independent,1417,3,1420,S193
7017,VIJAY KUMAR,Independent,1388,0,1388,S193
7018,DILBAGH SINGH,All India Mazdoor Party (Rangreta),1363,11,1374,S193
7019,SIMRANJEET SINGH,Independent,1338,3,1341,S193
7020,MAHINDER SINGH HAMIRA,Independent,1044,2,1046,S193
7021,NAVEEN KUMAR SHARMA,Sanjhi Virasat Party,823,1,824,S193
7022,NOTA,None of the Above,3420,32,3452,S193
7023,SUDHAKAR SINGH,Rashtriya Janata Dal,435062,3283,438345,S0433
7024,MITHILESH TIWARI,Bharatiya Janata Party,405795,2459,408254,S0433
7025,ANIL KUMAR,Bahujan Samaj Party,114312,402,114714,S0433
7026,ANAND MISHRA S/O- PARAM HANS MISHRA,Independent,46527,882,47409,S0433
7027,DADAN YADAV,Independent,15653,183,15836,S0433
7028,SUDHAKAR MISHRA,Independent,12742,7,12749,S0433
7029,SUNIL KUMAR DUBY,Independent,7757,2,7759,S0433
7030,RAM SWAROOP CHAUHAN,Independent,5506,10,5516,S0433
7031,RAJU SINGH,Bahujan Mukti Party,4322,17,4339,S0433
7032,AANAND MISRA S/O MADAN KUMAR MISRA,Independent,2697,137,2834,S0433
7033,BHAGWAN SINGH YADAV,Independent,2045,8,2053,S0433
7034,NIRANJAN KUMAR RAY,Independent,1667,2,1669,S0433
7035,HEM LATA,Jagrook Janta Party,1554,16,1570,S0433
7036,AKHILESH KUMAR PANDEY,Independent,1089,6,1095,S0433
7037,NOTA,None of the Above,9572,45,9617,S0433
7038,GAJENDRA SINGH SHEKHAWAT,Bharatiya Janata Party,722978,7078,730056,S2016
7039,KARAN SINGH UCHIYARDA,Indian National Congress,608228,6151,614379,S2016
7040,SUNIL KUMAR PAREEK,Independent,7424,5,7429,S2016
7041,MANJU MEGHWAL,Bahujan Samaj Party,6347,48,6395,S2016
7042,ANANDARAM URF ANAND CHAUHAN,Aazad Samaj Party (Kanshi Ram),3662,18,3680,S2016
7043,SUNIL BHANDARI,Independent,3236,2,3238,S2016
7044,VISHEK VISHNOI,Independent,1718,32,1750,S2016
7045,SHIVA RAM,Independent,1191,4,1195,S2016
7046,LIKHAMA RAM,Independent,1123,2,1125,S2016
7047,NARESH KANDARA,Independent,1007,20,1027,S2016
7048,SATYANARAYAN,Bharatiya Sampuran Krantikari Party,776,6,782,S2016
7049,PAPPU DAN,Right to Recall Party,650,4,654,S2016
7050,SHAHNAZ BANO,Dalit Kranti Dal,546,1,547,S2016
7051,RAM DAYAL BISHNOI,Rashtriya Janshakti Party (Secular),491,12,503,S2016
7052,BHOM SINGH,Indian Peoples Green Party,483,4,487,S2016
7053,NOTA,None of the Above,10511,80,10591,S2016
7054,MOHMAD HANEEFA,Independent,64443,816,65259,U091
7055,TSERING NAMGYAL,Indian National Congress,35770,1627,37397,U091
7056,TASHI GYALSON,Bharatiya Janata Party,31505,451,31956,U091
7057,NOTA,None of the Above,896,16,912,U091
7058,MURASOLI S,Dravida Munnetra Kazhagam,498822,3423,502245,S2230
7059,SIVANESAN P,Desiya Murpokku Dravida Kazhagam,182172,490,182662,S2230
7060,MURUGANANTHAM M,Bharatiya Janata Party,169587,1026,170613,S2230
7061,HUMAYUN KABIR,Naam Tamilar Katchi,119683,610,120293,S2230
7062,RENGASAMY C,Independent,18130,61,18191,S2230
7063,SARAVANAN M,Independent,6730,65,6795,S2230
7064,SENTHIL KUMAR N,Independent,4133,25,4158,S2230
7065,EZHILARASAN S,Independent,3834,17,3851,S2230
7066,JAYABAL A,Bahujan Samaj Party,2400,10,2410,S2230
7067,SANTHOSH M,Independent,1982,10,1992,S2230
7068,ER ARJUN S,Independent,1440,6,1446,S2230
7069,KARIKALA CHOLAN S,Independent,1209,8,1217,S2230
7070,NOTA,None of the Above,12674,159,12833,S2230
7071,VIJAY KUMAR HANSDAK,Jharkhand Mukti Morcha,607293,6078,613371,S271
7072,TALA MARANDI,Bharatiya Janata Party,430544,4563,435107,S271
7073,LOBIN HEMBRAM,Independent,41592,548,42140,S271
7074,GOPIN SOREN,Communist Party of India  (Marxist),37191,100,37291,S271
7075,MAHESH PAHARIYA,Independent,14950,28,14978,S271
7076,AJIT MARANDI,Rashtriya Jansambhavna Party,11243,8,11251,S271
7077,SEBASTION HEMBROM,Independent,9492,1,9493,S271
7078,MARIYAM MARANDI,Bahujan Samaj Party,8225,34,8259,S271
7079,PAUL SOREN,All India Majlis-E-Ittehadul Muslimeen,7854,48,7902,S271
7080,DIPA TUDU,Independent,6847,9,6856,S271
7081,KHALIFA KISKU,Peoples Party of India (Democratic),4092,15,4107,S271
7082,VINOD KUMAR MANDAL,Lokhit Adhikar Party,3774,35,3809,S271
7083,MUNSHI KISKU,Navyug Pragatisheel Morcha,2777,2,2779,S271
7084,LILI HANSDA,Samata Party,2682,7,2689,S271
7085,NOTA,None of the Above,18119,98,18217,S271
7086,MAHIMA KUMARI MEWAR,Bharatiya Janata Party,775243,5960,781203,S2022
7087,DR. DAMODAR GURJAR,Indian National Congress,385359,3621,388980,S2022
7088,RAMAKISHAN BHADU,Bahujan Samaj Party,9097,38,9135,S2022
7089,NEERU RAM KAPRI,Independent,7820,11,7831,S2022
7090,DHARAM SINGH RAWAT,Independent,3993,60,4053,S2022
7091,NARAYAN SONI,Independent,3367,7,3374,S2022
7092,GHANSHYAM SINGH,Bhartiya Jan Adhikar Party,1917,23,1940,S2022
7093,JITENDRA KUMAR KHATIK,Independent,1802,13,1815,S2022
7094,DR. ARPIT CHHAJER,Independent,1235,9,1244,S2022
7095,PRAMOD KUMAR VERMA,Bheem Tribal Congress,1134,10,1144,S2022
7096,NOTA,None of the Above,12339,72,12411,S2022
7097,MAHUA MOITRA,All India Trinamool Congress,624711,4078,628789,S2512
7098,AMRITA ROY,Bharatiya Janata Party,567628,4456,572084,S2512
7099,S.M. SADI,Communist Party of India  (Marxist),179063,1138,180201,S2512
7100,SANJIT BISWAS,Independent,8660,11,8671,S2512
7101,SOURAV HELA,Independent,5061,4,5065,S2512
7102,NEMAI BISWAS,Independent,5047,22,5069,S2512
7103,AMAL CHANDRA SARKAR,Bahujan Samaj Party,5045,55,5100,S2512
7104,AFROJA KHATUN MONDAL,All India Secular Front,4284,14,4298,S2512
7105,ISMAT ARA MONDAL,Socialist Unity Centre Of India (COMMUNIST),3603,19,3622,S2512
7106,MD. MUKTAR SHAIKH,Independent,3287,7,3294,S2512
7107,ALIK KUMAR KUNDU,Independent,2699,9,2708,S2512
7108,NOTA,None of the Above,6754,57,6811,S2512
7109,RAMESH AWASTHI,Bharatiya Janata Party,440609,2446,443055,S2443
7110,ALOK MISRA,Indian National Congress,419469,2618,422087,S2443
7111,KULDEEP BHADAURIYA,Bahujan Samaj Party,11843,189,12032,S2443
7112,ASHOK PASWAN ADVOCATE,Sabhi Jan Party,1969,5,1974,S2443
7113,ALOK MISHRA,Independent,1186,12,1198,S2443
7114,MANOJ KUMAR,Independent,776,2,778,S2443
7115,AJAY KUMAR MISHRA,Independent,671,1,672,S2443
7116,PRASHAST DHEER,All India Forward Bloc,462,3,465,S2443
7117,ARVIND KUMAR SRIVASTAVA,Independent,394,4,398,S2443
7118,SANJAY SINGH,"Proutist Bloc, India",348,2,350,S2443
7119,VALENDRA KATIYAR,Socialist Unity Centre Of India (COMMUNIST),267,3,270,S2443
7120,NOTA,None of the Above,4048,69,4117,S2443
7121,RAMASAHAYAM RAGHURAM REDDY,Indian National Congress,759603,7326,766929,S2917
7122,NAMA NAGESWARA RAO,Bharat Rashtra Samithi,297592,1490,299082,S2917
7123,VINOD RAO TANDRA,Bharatiya Janata Party,117075,1561,118636,S2917
7124,VASAM RAMAKRISHNA DORA,Independent,6200,15,6215,S2917
7125,ULLENGALA YADAGIRI,Independent,6063,1,6064,S2917
7126,ADVOCATE YERRA KAAMESH,Bahujan Samaj Party,6030,71,6101,S2917
7127,KUKKALA NAGAIAH,Alliance of Democratic Reforms Party,5724,19,5743,S2917
7128,KATUKOJWALA NAGESWAR RAO,Independent,4111,3,4114,S2917
7129,CHILAKABATHINI STALIN,Independent,3112,1,3113,S2917
7130,SHAIK BAJI BABA,Independent,2422,2,2424,S2917
7131,KASIMALLA NAGESWARA RAO,Independent,2232,5,2237,S2917
7132,BANDARU NAGARAJU,Independent,2122,0,2122,S2917
7133,SHAIK KHALEEL PASHA,Independent,2023,5,2028,S2917
7134,EDURUGATLA CHITTI MALLU,Independent,1848,6,1854,S2917
7135,GANGIREDDY KOTI REDDY,Independent,1789,1,1790,S2917
7136,SHAIK SIRAJUDDIN,Independent,1661,2,1663,S2917
7137,SHAIK AJJULU,Independent,1342,0,1342,S2917
7138,KOPPULA SRINIVASA RAO,Jaibhim Rao Bharat Party,1271,2,1273,S2917
7139,MADDISETTY YERRAPPA @ AJAY,Independent,1043,10,1053,S2917
7140,SHAIK MOHMED RASOOL,Independent,1021,1,1022,S2917
7141,LINGALA RAVI KUMAR,Independent,1017,1,1018,S2917
7142,AVUTAPALLI RAMBABU,Independent,948,2,950,S2917
7143,TEJAVATH JOGRAM NAIK,Independent,914,5,919,S2917
7144,ANWAR RAICE,Socialist Party (India),754,0,754,S2917
7145,ANANDA PRASAD KASINA,Pyramid Party of India,714,4,718,S2917
7146,LINGAIAH DANDA,Independent,693,7,700,S2917
7147,ANIL KUMAR MADDINENI,Independent,689,4,693,S2917
7148,PAPETLA RAMAMURTHY,Sakala Janula Party,659,2,661,S2917
7149,ANTHONI SURESH,Bahujana Left Party,607,9,616,S2917
7150,M. RAVI CHANDAR CHOWHAN,Independent,597,4,601,S2917
7151,THAMBALLA RAVI,Independent,503,5,508,S2917
7152,BHATTU SRINIVAS,Jai Bharat National Party,472,4,476,S2917
7153,NAGESWARA RAO LAKAVATH,Independent,363,5,368,S2917
7154,MALAMPATI SURYANARAYANA,Independent,362,1,363,S2917
7155,MUTYAM ARJUNA RAJU,Independent,349,2,351,S2917
7156,NOTA,None of the Above,6657,125,6782,S2917
7157,ROBERT BRUCE C,Indian National Congress,499493,2803,502296,S2238
7158,NAINAR NAGENTHRAN,Bharatiya Janata Party,334431,2245,336676,S2238
7159,JANSI RANI M,All India Anna Dravida Munnetra Kazhagam,88996,605,89601,S2238
7160,SATHYA,Naam Tamilar Katchi,86918,768,87686,S2238
7161,POTTAL SUNDARA MUNISWARAN,Independent,19802,50,19852,S2238
7162,ATHISAYAM V,Independent,3744,37,3781,S2238
7163,BALASUBRAMANIAN,Bahujan Samaj Party,2044,23,2067,S2238
7164,CHINNA MAHARAJA K,Independent,1888,7,1895,S2238
7165,DAVID M,Independent,1829,7,1836,S2238
7166,SAMUEL LAWRENCE PONNIAH,Independent,1493,4,1497,S2238
7167,BISHOP DR GODFREY WASHINGTON NOBLE,Aanaithinthiya Jananayaka Pathukappu Kazhagam,1457,18,1475,S2238
7168,LENIN K,Independent,1441,9,1450,S2238
7169,CHANDRAN M,Veerath Thiyagi Viswanathadoss Thozhilalarkal Katchi,1409,4,1413,S2238
7170,SELVA KUMAR S,Bahujan Dravida Party,1317,29,1346,S2238
7171,KUMAR V,Puthiya Makkal Tamil Desam Katchi,1057,15,1072,S2238
7172,MUTHURAMAN A,Aravor Munnetra Kazhagam,1046,2,1048,S2238
7173,THALAPATHY MURUGAN M,Independent,913,4,917,S2238
7174,SIVARAM K,Independent,855,20,875,S2238
7175,RAMAKRISHNAN N,Nam India Naam Indiyar Katchi,790,0,790,S2238
7176,SURESH,Independent,777,11,788,S2238
7177,DR RAJENDRA RETNAM K,Independent,685,4,689,S2238
7178,SEVAL KANNAN B ADVOCATE,Independent,622,14,636,S2238
7179,RAGHAVAN C M,Independent,364,2,366,S2238
7180,NOTA,None of the Above,7285,111,7396,S2238
7181,DHAIRYASHEEL SAMBHAJIRAO MANE,Shiv Sena,518334,1856,520190,S1348
7182,SATYAJEET BABASAHEB PATIL (AABA) SARUDKAR,Shiv Sena (Uddhav Balasaheb Thackrey),504181,2583,506764,S1348
7183,RAJU SHETTI,Swabhimani Paksha,178866,984,179850,S1348
7184,D. C. PATIL DADASAHEB / DADGONDA CHAVGONDA PATIL,Vanchit Bahujan  Aaghadi,32591,105,32696,S1348
7185,ASLAM AINODIN MULLA,Independent,6107,4,6111,S1348
7186,ANANDRAO VASANTRAO SARNAIK (FOUJI BAPU),Independent,4944,11,4955,S1348
7187,TANDALE LAXMAN SHIVAJI,Independent,4788,1,4789,S1348
7188,PROF. PARASHURAM MANE,Independent,4467,10,4477,S1348
7189,KAMBLE RAVINDRA TUKARAM,Bahujan Samaj Party,3968,65,4033,S1348
7190,SATYAJEET PATIL (AABA),Independent,3602,30,3632,S1348
7191,ANANDRAO TUKARAM THORAT,Independent,3497,2,3499,S1348
7192,IMRAN IQBAL KHATIB,Bahujan Mukti Party,3172,18,3190,S1348
7193,RAGHUNATHDADA PATIL,Bharatheeya Jawan Kisan Party,2146,28,2174,S1348
7194,JAVED SIKANDAR MUJAVAR,Independent,1849,3,1852,S1348
7195,SANTOSH KERBA KHOT,Kamgaar Kisan Party,1697,4,1701,S1348
7196,DR. ISHWAR MAHADEV YAMGAR,Bharatiya Lokshakti Party,1520,17,1537,S1348
7197,SHIVAJI DHONDIRAM SANKPAL,Independent,1390,2,1392,S1348
7198,SHARAD BABURAO PATIL,National Black Panther Party,1356,5,1361,S1348
7199,MANOHAR PRADIP SATPUTE,Independent,1063,3,1066,S1348
7200,DHANAJI JAGANNATH GURAV (SHIVAREKAR),Lokrajya Janata Party,1054,7,1061,S1348
7201,DAVARI LAXMAN SHRIPATI,Independent,1004,5,1009,S1348
7202,RAJENDRA BHIMRAO MANE,Independent,935,5,940,S1348
7203,DINAKARRAO TULSHIDAS CHAVAN (PATIL),All India Forward Bloc,674,5,679,S1348
7204,RAMCHANDRA GOVINDRAO SALUNKHE,Independent,618,0,618,S1348
7205,MOHITE DEVENDRA NANA,Independent,559,1,560,S1348
7206,MANE ARVIND BHIVA,Independent,422,2,424,S1348
7207,MAHAMMAD MUBARAK DARAVESHI,Independent,360,1,361,S1348
7208,NOTA,None of the Above,5027,76,5103,S1348
7209,ISHA KHAN CHOUDHURY,Indian National Congress,570966,1429,572395,S258
7210,SREERUPA MITRA CHAUDHURY (NIRBHAYA DIDI),Bharatiya Janata Party,441531,2496,444027,S258
7211,SHAHNAWAZ ALI RAIHAN,All India Trinamool Congress,299825,1201,301026,S258
7212,PURNOCHANDRA MANDAL,Independent,8381,2,8383,S258
7213,AHMED HEDATUL HASAN,Independent,5735,1,5736,S258
7214,MD. JAMAL SAIKH,Independent,5386,0,5386,S258
7215,BIKASH RABIDAS,Bahujan Samaj Party,5054,11,5065,S258
7216,BIJOY KUMAR SARKAR,Independent,4773,3,4776,S258
7217,SUSMITA DEY KARJEE,Bhartiya Lokmat Rashtrwadi Party,3521,14,3535,S258
7218,AMAL KUMAR RABIDAS,Independent,3263,8,3271,S258
7219,KAVIR MADAN DAS,Ambedkarite Party of India,3137,3,3140,S258
7220,ASIM MANDAL,Jan Sangh Party,2786,2,2788,S258
7221,MD SHAHNAWAJ RAHMATULLAH,Social Democratic Party Of India,2315,8,2323,S258
7222,JALALUDDIN SARKAR,Bharatiya Nyay-Adhikar Raksha Party,2075,0,2075,S258
7223,ANGSHUDHAR MANDAL,Socialist Unity Centre Of India (COMMUNIST),1178,11,1189,S258
7224,MD NUR ISLAM SEKH,Rashtriya Secular Majlis Party,1130,6,1136,S258
7225,MD MONIRUL HASAN,Jamat-E-Seratul Mustakim,737,4,741,S258
7226,NOTA,None of the Above,2759,38,2797,S258
7227,R.K. CHAUDHARY,Samajwadi Party,666560,1309,667869,S2434
7228,KAUSHAL KISHORE,Bharatiya Janata Party,596197,1380,597577,S2434
7229,RAJESH KUMAR,Bahujan Samaj Party,88257,204,88461,S2434
7230,MAHENDRA,Independent,2654,7,2661,S2434
7231,SUSHIL KUMAR,Independent,2626,1,2627,S2434
7232,RAMESH KUMAR,Independent,1839,2,1841,S2434
7233,SUNITA CHHEDA PASI,Aam Janta Party (India),1736,13,1749,S2434
7234,S. L.SINGH,Peoples Party of India (Democratic),1711,6,1717,S2434
7235,BRIJESH KUMAR VIKRAM,Rashtriya Samaj Paksha,1648,7,1655,S2434
7236,JITENDRA KUMAR,Independent,1402,12,1414,S2434
7237,SURAJ KUMAR,Sardar Patel Siddhant Party,1010,5,1015,S2434
7238,NOTA,None of the Above,8838,28,8866,S2434
7239,B K PARTHASARATHI,Telugu Desam,713013,12521,725534,S0120
7240,J SHANTHA,Yuvajana Sramika Rythu Congress Party,587406,5701,593107,S0120
7241,B A SAMAD SHAHEEN,Indian National Congress,53989,1070,55059,S0120
7242,BHAGYA R S,Bahujan Samaj Party,7949,66,8015,S0120
7243,PRATHAP REDDY GORLA,Independent,5380,64,5444,S0120
7244,H D HANUMANTHE GOWD,Independent,2270,8,2278,S0120
7245,ANJINAPPA GARI SREENIVASULU,Revolutionary Socialist Party,2045,6,2051,S0120
7246,S N SURESH,Independent,1611,20,1631,S0120
7247,DASAGANIPALLI KULLAYAPPA,Independent,1317,11,1328,S0120
7248,ASHOK,Socialist Unity Centre Of India (COMMUNIST),1282,10,1292,S0120
7249,T SUDHAKAR REDDY,Independent,1227,10,1237,S0120
7250,S RAGHUNATHA REDDY,Independent,693,17,710,S0120
7251,BUDILI DHANUNJAYA,National Nava Kranthi Party,679,3,682,S0120
7252,NOTA,None of the Above,17826,145,17971,S0120
7253,DAROGA PRASAD SAROJ,Samajwadi Party,437567,2392,439959,S2468
7254,NEELAM SONKER,Bharatiya Janata Party,324106,830,324936,S2468
7255,INDU CHAUDHRI,Bahujan Samaj Party,209308,745,210053,S2468
7256,GANGADEEN,Communist Party of India,12263,8,12271,S2468
7257,BALINDAR,Janta Kranti Party (Rashtravadi),4157,1,4158,S2468
7258,SUSHMITA SAROJ,Independent,2621,5,2626,S2468
7259,RAM PYARE SHARAN VIJAITA,Independent,2337,4,2341,S2468
7260,NOTA,None of the Above,7075,19,7094,S2468
7261,SAPTAGIRI SANKAR ULAKA,Indian National Congress,469295,2098,471393,S1821
7262,KAUSALYA HIKAKA,Biju Janata Dal,322797,852,323649,S1821
7263,KALIRAM MAJHI,Bharatiya Janata Party,230792,1722,232514,S1821
7264,DAMINI JANI,Bahujan Samaj Party,15373,54,15427,S1821
7265,PRAKASH HIKAKA,Communist Party of India  (Marxist-Leninist)  (Liberation),14847,5,14852,S1821
7266,LASU HANTAL,Independent,14362,11,14373,S1821
7267,RAGHUMANI GOMANGO,Independent,10528,12,10540,S1821
7268,ABINASH GOMANGO,Independent,10258,16,10274,S1821
7269,SUMAN KANTA,Naba Bharata Nirmana Seva Party,8386,10,8396,S1821
7270,SANTOSH KUMAR BIDIKA,Republican Party of India (A),5413,2,5415,S1821
7271,PRAMILA PUJARI,Socialist Unity Centre Of India (COMMUNIST),4866,12,4878,S1821
7272,NOTA,None of the Above,37106,25,37131,S1821
7273,JOYANTA BASUMATARY,"United People’s Party, Liberal",484681,4314,488995,S031
7274,KAMPA BORGOYARI,Bodoland Peoples Front,432768,4644,437412,S031
7275,GARJAN MASHAHARY,Indian National Congress,112624,1112,113736,S031
7276,BINITA DEKA,Gana Suraksha Party,93266,923,94189,S031
7277,PRITHVIRAJ NARAYAN DEV MECH,Independent,33636,101,33737,S031
7278,GAURI SANKAR SARANIA,All India Trinamool Congress,23362,157,23519,S031
7279,RANJAY KR BRAHMA,Independent,8782,48,8830,S031
7280,LALIT PEGU,Voters Party  International,7891,41,7932,S031
7281,JYOTISH KUMAR DAS,Independent,5944,162,6106,S031
7282,PANKAJ ISLARY,Independent,4473,35,4508,S031
7283,TRIPTINA RABHA,Independent,4425,115,4540,S031
7284,AJOY NARZARY,Independent,4032,48,4080,S031
7285,NOTA,None of the Above,13662,250,13912,S031
7286,BANDI SANJAY KUMAR,Bharatiya Janata Party,578827,6289,585116,S293
7287,VELCHALA RAJENDER RAO,Indian National Congress,357446,2461,359907,S293
7288,VINOD KUMAR BOIANAPALLI,Bharat Rashtra Samithi,280867,1296,282163,S293
7289,ABBADI BUCHI REDDY,Independent,11602,10,11612,S293
7290,ARUNA THALLAPALLY,Alliance of Democratic Reforms Party,9043,21,9064,S293
7291,KOTA SHYAM KUMAR,Independent,8744,12,8756,S293
7292,ANOSE KATKOORI,Independent,8699,7,8706,S293
7293,MAREPALLI MOGILAIAH,Bahujan Samaj Party,8010,99,8109,S293
7294,RAJENDER POTHURI,Independent,3250,7,3257,S293
7295,SRAVAN PEDDAPELLY,Bharathiya YuvaKula Dalam,3068,6,3074,S293
7296,GADDA SATHISH,Independent,2936,9,2945,S293
7297,ANILREDDY KADTHALA,National Nava Kranthi Party,2747,7,2754,S293
7298,CHILUVERU SRIKANTH,Dharma Samaj Party,2553,33,2586,S293
7299,AKSHAY KUMAR MEKALA,Independent,2219,5,2224,S293
7300,JOURNALIST VIKRAM REDDY VEMULAA,Independent,2090,6,2096,S293
7301,ASHOK PANCHIKA,Social Justice Party of India,1914,10,1924,S293
7302,GAVVALA LAXMI,Independent,1738,6,1744,S293
7303,GATTAIAH YADAV BARIGE,Independent,1688,6,1694,S293
7304,RANAPRATAP GATTU,Socialist Party (India),1606,7,1613,S293
7305,GUDISHE  MOHAN,Independent,1471,3,1474,S293
7306,MANASA PERALA,Independent,1106,19,1125,S293
7307,PODISHETTI SAMMAIAH,Bahujan Mukti Party,994,0,994,S293
7308,VENKATANARSAIAH DYAGALA @ DEGALA,Independent,926,2,928,S293
7309,SHIVARATRI SRINIVAS,Independent,887,2,889,S293
7310,CHINTHA ANILKUMAR,Pyramid Party of India,823,7,830,S293
7311,CHEEKOTI VARUN KUMAR GUPTA,Telugu Congress Party,783,7,790,S293
7312,RAPOLE RAMKUMAR BHARADWAJ,Independent,572,3,575,S293
7313,DEVUNOORI SRINIVASU,Independent,465,0,465,S293
7314,NOTA,None of the Above,5373,65,5438,S293
7315,NITYANAND RAI,Bharatiya Janata Party,515159,806,515965,S0422
7316,ALOK KUMAR MEHTA,Rashtriya Janata Dal,454870,993,455863,S0422
7317,SANJAY PASWAN,Independent,16961,2,16963,S0422
7318,MOHAN KUMAR MAURYA,Bahujan Samaj Party,7081,20,7101,S0422
7319,RAKESH KUMAR,Independent,5953,4,5957,S0422
7320,SANTHOSH RAI,Rashtriya Jansambhavna Party,4423,3,4426,S0422
7321,NARENDRA GIRI,Independent,3150,1,3151,S0422
7322,KISHOR KUMAR,Independent,2209,0,2209,S0422
7323,AMARESH RAY,Independent,2140,3,2143,S0422
7324,ANSHU KUMAR,Subhashwadi Bhartiya Samajwadi Party (Subhas Party),1749,7,1756,S0422
7325,RAMPUKAR RAY,Socialist Unity Centre Of India (COMMUNIST),1299,7,1306,S0422
7326,NIKKI JHA,Jagrook Janta Party,1006,14,1020,S0422
7327,MANOJ KUMAR,Janta Raj Vikas Party,937,2,939,S0422
7328,NOTA,None of the Above,23246,23,23269,S0422
7329,H.D. KUMARASWAMY,Janata Dal  (Secular),847482,4399,851881,S1020
7330,VENKATARAMANE GOWDA (STAR CHANDRU),Indian National Congress,564778,2483,567261,S1020
7331,CHANDAN GOWDA. K,Independent,12310,84,12394,S1020
7332,SHIVASHANKARA. S,Bahujan Samaj Party,6903,61,6964,S1020
7333,RAMAIAH. D,Independent,3796,14,3810,S1020
7334,RANJITHA. N,Independent,2897,12,2909,S1020
7335,CHANDRASHEKARA. K.R (CHANDRU KEELARA),Karnataka Rashtra Samithi,1465,11,1476,S1020
7336,BUDAYYA. B.P,Karunaadu Party,1358,12,1370,S1020
7337,LOKESHA. S (AARYA LOKESH),Uttama Prajaakeeya Party,1151,12,1163,S1020
7338,BEERESH. C.T (SAINIKA BEERESH),Independent,919,12,931,S1020
7339,N.BASAVARAJU,Independent,802,41,843,S1020
7340,H.D. REVANNA,Purvanchal Mahapanchayat,584,6,590,S1020
7341,CHANNAMAYIGOWDA,Independent,496,1,497,S1020
7342,S.ARVIND,Independent,440,2,442,S1020
7343,NOTA,None of the Above,7706,30,7736,S1020
7344,BENNY BEHANAN,Indian National Congress,390216,3955,394171,S1111
7345,PROF C RAVEENDRANATH,Communist Party of India  (Marxist),327382,3035,330417,S1111
7346,K A UNNIKRISHNAN,Bharath Dharma Jana Sena,105706,694,106400,S1111
7347,ADV CHARLY PAUL,Twenty 20 Party,105020,622,105642,S1111
7348,ROSILIN CHACKO,Bahujan Samaj Party,2377,33,2410,S1111
7349,BOSCO KALAMASSERY,Independent,1071,16,1087,S1111
7350,SUBRAN K R,Independent,789,10,799,S1111
7351,DR M PRADEEPAN,Socialist Unity Centre Of India (COMMUNIST),688,6,694,S1111
7352,ARUN EDATHADAN,Independent,662,24,686,S1111
7353,T S CHANDRAN,Independent,481,50,531,S1111
7354,JOHNSON K C,Independent,379,8,387,S1111
7355,NOTA,None of the Above,8021,42,8063,S1111
7356,KOTA SRINIVAS POOJARY,Bharatiya Janata Party,728219,4015,732234,S1015
7357,K. JAYAPRAKASH HEGDE,Indian National Congress,470769,2290,473059,S1015
7358,K.T. RADHAKRISHNA,Bahujan Samaj Party,5378,39,5417,S1015
7359,SUDHEER KANCHAN MARAKALA,Independent,2281,5,2286,S1015
7360,SACHIN B.K,Uttama Prajaakeeya Party,1299,34,1333,S1015
7361,M. K. DAYANANDA,Proutist Sarva Samaj,1049,20,1069,S1015
7362,VIJAY KUMAR M. G,Independent,943,13,956,S1015
7363,SUPREETH KUMAR POOJARY KATEEL,Janahitha Paksha,670,20,690,S1015
7364,SHABAREESH,Karunada Sevakara Party,560,5,565,S1015
7365,L. RANGANATH GOWDA,Karnataka Rashtra Samithi,536,4,540,S1015
7366,NOTA,None of the Above,11235,34,11269,S1015
7367,CHARANJIT SINGH CHANNI,Indian National Congress,389509,544,390053,S194
7368,SUSHIL KUMAR RINKU,Bharatiya Janata Party,213702,358,214060,S194
7369,PAWAN KUMAR TINU,Aam Aadmi Party,208549,340,208889,S194
7370,MOHINDER SINGH KAYPEE,Shiromani Akali Dal,67811,100,67911,S194
7371,ADVOCATE BALWINDER KUMAR,Bahujan Samaj Party,64856,85,64941,S194
7372,SARABJIT SINGH KHALSA,Shiromani Akali Dal (Amritsar)(Simranjit Singh Mann),19252,32,19284,S194
7373,MASTER PARSHOTAM LAL BILGA,Communist Party of India  (Marxist),5948,10,5958,S194
7374,IQBAL CHAND MATTU,Independent,1956,0,1956,S194
7375,NEETU SHATTRA WALA,Independent,1878,1,1879,S194
7376,AMRISH BHAGAT,Independent,1183,1,1184,S194
7377,GURDEEP SINGH BITTU,Independent,1112,1,1113,S194
7378,RAJ KUMAR SAQI,Peoples Party of India (Democratic),1087,1,1088,S194
7379,SONIA,Republican Party of India (Athawale),1054,1,1055,S194
7380,RAJWANT KAUR KHALSA,Apna Samaj Party,948,4,952,S194
7381,BHAGAT GULSHAN AZAAD,Democratic Bharatiya Samaj Party,929,1,930,S194
7382,RAMESH LAL KALA,Independent,875,1,876,S194
7383,ASHOK KUMAR JAKHU,Independent,742,1,743,S194
7384,BAL MUKAND BAWRA,Global Republican Party,587,4,591,S194
7385,PARAMJIT KAUR TEJI,Independent,500,0,500,S194
7386,TARACHAND SHEELA,Loktantrik Lok Rajyam Party,400,1,401,S194
7387,NOTA,None of the Above,4724,19,4743,S194
7388,DEVENDRA SINGH ALIAS BHOLE SINGH,Bharatiya Janata Party,514256,3167,517423,S2444
7389,RAJARAM PAL,Samajwadi Party,469766,3312,473078,S2444
7390,RAJESH KUMAR DWIVEDI,Bahujan Samaj Party,72679,461,73140,S2444
7391,RAJARAM,Independent,4629,13,4642,S2444
7392,ASHOK PASWAN ADVOCATE,Sabhi Jan Party,3160,13,3173,S2444
7393,CHANDRESH SINGH,Bhartiya Shakti Chetna Party,2641,13,2654,S2444
7394,YOGESH JAISWAL,Independent,2529,14,2543,S2444
7395,VIPIN KUMAR,Rashtriya Sanskriti Party,1489,5,1494,S2444
7396,RAMGOPAL,Rashtriya Janutthan Party,1146,11,1157,S2444
7397,NOTA,None of the Above,7523,126,7649,S2444
7398,RAMASHANKAR RAJBHAR,Samajwadi Party,403616,1856,405472,S2471
7399,RAVINDAR KUSHAWAHA,Bharatiya Janata Party,400489,1410,401899,S2471
7400,BHIM RAJBHAR,Bahujan Samaj Party,80291,308,80599,S2471
7401,JAIBAHADUR ALIAS JAIBAHADUR CHAUHAN,Janta Kranti Party (Rashtravadi),8241,22,8263,S2471
7402,SHREENARAYAN MISHRA,Akhil Bhartiya Sarvjan Hit Party,3878,14,3892,S2471
7403,SADDAM HUSSAIN,Independent,3210,5,3215,S2471
7404,SHRIKRISHNA,Independent,2527,5,2532,S2471
7405,AMRESH THAKUR,Independent,2147,9,2156,S2471
7406,SURYA PRAKASH GAUTAM,Sardar Patel Siddhant Party,1782,3,1785,S2471
7407,NOTA,None of the Above,7520,29,7549,S2471
7408,PRATIMA MONDAL,All India Trinamool Congress,891053,3259,894312,S2519
7409,ASHOK KANDARY,Bharatiya Janata Party,422546,1547,424093,S2519
7410,MEGHNATH HALDER,All India Secular Front,65316,56,65372,S2519
7411,SAMARENDRA NATH MONDAL,Revolutionary Socialist Party,39927,186,40113,S2519
7412,NIRANJAN  NASKAR,Socialist Unity Centre Of India (COMMUNIST),14547,75,14622,S2519
7413,SUJAN SARDAR,Independent,10779,15,10794,S2519
7414,SINDHUPADA BAIRAGI,Independent,9150,12,9162,S2519
7415,SHANKAR DEB MONDAL,Bahujan Samaj Party,6363,28,6391,S2519
7416,JURAN CHANDRA PANDEY,Mulnibasi Party of India,3750,19,3769,S2519
7417,MILAN NASKAR,Independent,2129,7,2136,S2519
7418,PRATIMA MONDAL,Independent,2052,27,2079,S2519
7419,NOTA,None of the Above,9756,32,9788,S2519
7420,GANESH SINGH,Bharatiya Janata Party,458373,1355,459728,S129
7421,DABBU SIDDHARTH SUKHLAL KUSHWAHA,Indian National Congress,373982,797,374779,S129
7422,NARAYAN TRIPATHI,Bahujan Samaj Party,185303,315,185618,S129
7423,DURGESH KUMAR VISHWAKARMA,Independent,5919,2,5921,S129
7424,RAHUL DAHIYA,Independent,4276,1,4277,S129
7425,CHHEDI LAL PRAJAPATI (PANDA  BABA),Independent,4060,1,4061,S129
7426,CHANDRABHAN KOL,Independent,3393,5,3398,S129
7427,"SAFI ULLA ""DBBU BHAI""",Independent,2612,2,2614,S129
7428,ADV. ASHOK SAKET,Bahujan Dravida Party,2396,3,2399,S129
7429,AZEEZ AHMED QURAISHY,Manviya Bharat Party,2078,4,2082,S129
7430,MASTER JI AJIT KUMAR JAYSWAL,Peoples Party of India (Democratic),1887,4,1891,S129
7431,KALIM AHMAD BACHCHA,Independent,1622,8,1630,S129
7432,SUKHLAL VERMA RATNESH,Independent,1616,1,1617,S129
7433,ASHOK KUMAR GUPTA,Bhartiya Shakti Chetna Party,1259,6,1265,S129
7434,NANKU YADAV,Akhil Bharatiya Hind Kranti Party,1254,5,1259,S129
7435,RISHABH SINGH,Independent,1068,5,1073,S129
7436,ASHOK BAUDH,Independent,945,2,947,S129
7437,HARI SHANKAR TIWARI (LOHA WALA),Bharatiya Jan Morcha Party,935,10,945,S129
7438,RANJANA MISHRA,Nyaydharmsabha,905,10,915,S129
7439,NOTA,None of the Above,2538,15,2553,S129
7440,MAGUNTA SREENIVASULU REDDY,Telugu Desam,689829,12065,701894,S0116
7441,DR CHEVIREDDY BHASKAR REDD,Yuvajana Sramika Rythu Congress Party,644052,7643,651695,S0116
7442,EDA SUDHAKARA REDDY,Indian National Congress,25803,919,26722,S0116
7443,DHARANIKOTA LAKSHMI NARAYANA,Bahujan Samaj Party,6238,76,6314,S0116
7444,BUCHI EDUKONDALU,Independent,3046,2,3048,S0116
7445,PODILI RAMBABU,Independent,3035,38,3073,S0116
7446,ORSU VEENA,Jai Bharat National Party,2242,25,2267,S0116
7447,BONTHA RANGA REDDY,Independent,1923,0,1923,S0116
7448,BODDU KRANTHI KUMAR,Independent,1797,1,1798,S0116
7449,MOHAN GOUD J V,Independent,1442,5,1447,S0116
7450,U MADHU BABU,Independent,1006,2,1008,S0116
7451,KARATAPU RAJU,Independent,730,5,735,S0116
7452,JAGADEESH RAYAPATI,Independent,713,12,725,S0116
7453,DEVIREDDY BALANJANEYULU,Independent,710,6,716,S0116
7454,HARI PRASAD TUPAKULA,Independent,706,5,711,S0116
7455,PASAM VENKATESWARLU YADAV,Samajwadi Party,699,44,743,S0116
7456,SURYA TEJA KOTA,Pyramid Party of India,674,9,683,S0116
7457,AKUMALLA MALLIKARJUNA REDDY,Independent,575,0,575,S0116
7458,VESHAPOGU GURAVABABU,Independent,457,4,461,S0116
7459,KOMMU YOHANU,Liberation Congress Party,454,7,461,S0116
7460,SESHUBABU GUDDANTI,Independent,449,0,449,S0116
7461,SINGAMNENI SREEKANTH,Independent,407,3,410,S0116
7462,YARRA DASARADHARAMAIAH,Independent,394,0,394,S0116
7463,KOTA VAMSI KRISHNA,Independent,365,0,365,S0116
7464,K PAVAN KALYAN,Jatiya Jana Sena Party,362,30,392,S0116
7465,NOTA,None of the Above,13066,139,13205,S0116
7466,POONAMBEN HEMATBHAI MAADAM,Bharatiya Janata Party,618120,1929,620049,S0612
7467,ADVOCATE J. P. MARAVIYA,Indian National Congress,380949,1092,382041,S0612
7468,JAYSUKH NATHUBHAI PINGALSUR,Bahujan Samaj Party,11429,33,11462,S0612
7469,KANZARIYA RANCHHODBHAI NARANBHAI,Viro Ke Vir Indian Party,6973,29,7002,S0612
7470,VIJAYSINH PRAVINSINH JADEJA,Independent,4817,17,4834,S0612
7471,RATHOD PUNJABHAI PALABHAI,Independent,3727,5,3732,S0612
7472,BHURALAL MEGHJIBHAI PARMAR,Independent,1923,5,1928,S0612
7473,GHUGHA ALARAKHABHAI ISHAKBHAI,Independent,1582,3,1585,S0612
7474,KHIRA YUSUF SIDIKBHAI,Independent,1368,3,1371,S0612
7475,NANJI AMARSHI BATHWAR,Independent,1365,5,1370,S0612
7476,ANWAR NOORMAMAD SANGHAR,Independent,1299,0,1299,S0612
7477,PARESHBHAI PARSOTTAMBHAI MUNGARA,Rashtriya Mahaswaraj Bhumi Party,1266,4,1270,S0612
7478,POPATPUTRA RAFIK ABUBAKAR,Independent,1133,5,1138,S0612
7479,NADEEM MAHAMMAD HALA,Independent,1069,1,1070,S0612
7480,NOTA,None of the Above,10972,112,11084,S0612
7481,SUNIL BOSE,Indian National Congress,749926,1745,751671,S1022
7482,BALARAJ.S,Bharatiya Janata Party,561056,1909,562965,S1022
7483,M.KRISHNA MURTHY,Bahujan Samaj Party,15819,84,15903,S1022
7484,C.M.KRISHNA,Dr. Ambedkar People's Party,8074,15,8089,S1022
7485,G.D.RAJAGOPAL (H.D.KOTE),Independent,3949,5,3954,S1022
7486,SUMA.S,Socialist Unity Centre Of India (COMMUNIST),3821,5,3826,S1022
7487,MAHADEVASWAMY B M (PAMPI),Independent,3414,7,3421,S1022
7488,H.K.SWAMY HARADANAHALLI,Independent,3206,2,3208,S1022
7489,PATAS PRADEEP KUMAR.M,Independent,1969,17,1986,S1022
7490,KADAMBA. NAA. AMBARISH,Independent,1738,5,1743,S1022
7491,NINGARAJU.S,Karnataka Jantha Paksha,1406,5,1411,S1022
7492,KANDALLI MAHESH,Karnataka Rashtra Samithi,1249,3,1252,S1022
7493,NINGARAJ.G,Independent,1236,11,1247,S1022
7494,PRASANNA KUMAR.B,Karnataka Praja Party (RaithaParva),972,6,978,S1022
7495,NOTA,None of the Above,8094,49,8143,S1022
7496,DURAI VAIKO,Marumalarchi Dravida Munnetra Kazhagam,538877,3336,542213,S2224
7497,KARUPPAIAH. P,All India Anna Dravida Munnetra Kazhagam,227445,1674,229119,S2224
7498,RAJESSH. T,Naam Tamilar Katchi,106752,706,107458,S2224
7499,SENTHILNATHAN. P,Amma Makkal Munnettra Kazagam,99561,1186,100747,S2224
7500,SELVARAJ. S,Independent,14781,15,14796,S2224
7501,DAMODARAN. S,Independent,5138,28,5166,S2224
7502,ALLIMUTHU. M,Bahujan Samaj Party,4353,78,4431,S2224
7503,RAJENDRAN. S,Independent,3489,10,3499,S2224
7504,JEEVANANTHAM. M,Independent,2879,73,2952,S2224
7505,SAKTHIVEL,Anna Puratchi Thalaivar Amma Dravida Munnetra Kazhagam,2587,59,2646,S2224
7506,KARUPPIAH. S,Independent,2156,15,2171,S2224
7507,BACKIYARAJ VELLAISAMY,Naadaalum Makkal Katchi,2120,163,2283,S2224
7508,SATHIS KUMAR. S,Independent,2048,4,2052,S2224
7509,KAVITHA. S,Independent,1719,17,1736,S2224
7510,NAGARAJAN. M,Independent,1656,8,1664,S2224
7511,GOVINDARASU. P,Independent,1562,4,1566,S2224
7512,ANBIN AMUDHAN. R,Independent,1492,6,1498,S2224
7513,DURAIRAJ. A,Independent,1455,8,1463,S2224
7514,SASIKUMAR. P,Independent,1346,6,1352,S2224
7515,PANNEERSELVAM. P,Independent,1255,8,1263,S2224
7516,DURAI. S,Independent,1198,4,1202,S2224
7517,ANAND SELVARAJ,Independent,1172,6,1178,S2224
7518,SANKAR. R,Independent,1162,4,1166,S2224
7519,AMBIVENKATESAN,Independent,972,6,978,S2224
7520,DURAI. T,Independent,877,3,880,S2224
7521,SATHYAMURTHY. T,Independent,826,8,834,S2224
7522,VIJAYAKUMAR. P,Independent,797,5,802,S2224
7523,PERIYASAMY. V,Independent,771,3,774,S2224
7524,AKILA. M,Independent,742,5,747,S2224
7525,ROJA RAMANI. S,Anna MGR Dravida Makkal Kalgam,738,39,777,S2224
7526,RAJENDRAN. P,Independent,674,1,675,S2224
7527,MANIKANDARAJ. S,Independent,601,7,608,S2224
7528,MURUGESAN. P,Independent,494,3,497,S2224
7529,JOSEPH. L,Samaniya Makkal Nala Katchi,482,9,491,S2224
7530,MUTHURAJA. T,Independent,428,3,431,S2224
7531,NOTA,None of the Above,13560,289,13849,S2224
7532,NAVASKANI K,Indian Union Muslim League,506690,2974,509664,S2235
7533,PANNEERSELVAM O S/O OTTAKARATHEVAR,Independent,340778,2104,342882,S2235
7534,JEYAPERUMAL P,All India Anna Dravida Munnetra Kazhagam,98757,1023,99780,S2235
7535,DR CHANDRA PRABHA JEYAPAL,Naam Tamilar Katchi,96701,971,97672,S2235
7536,MUVITH KUMAR N,Independent,7901,18,7919,S2235
7537,SENTHILMALLAR K,Independent,6629,198,6827,S2235
7538,SIVASHANKAR N,Independent,6583,10,6593,S2235
7539,KANNADHASAN R,Independent,3485,17,3502,S2235
7540,SELVARAJ G,Puthiya Makkal Tamil Desam Katchi,2943,14,2957,S2235
7541,PANNEERSELVAM O S/O OCHAPPAN,Independent,2939,42,2981,S2235
7542,PANCHAVARNAM V,Independent,2561,11,2572,S2235
7543,PARIRAJAN C,Veerath Thiyagi Viswanathadoss Thozhilalarkal Katchi,2493,4,2497,S2235
7544,PANNIR SELVAM M  S/O MALAIYANDI,Independent,2387,15,2402,S2235
7545,NAWASKHAN,Independent,2301,22,2323,S2235
7546,SIVANANDAM N,Bahujan Samaj Party,1958,56,2014,S2235
7547,PANNEERSELVAM O  S/O  OYYADEVAR,Independent,1920,9,1929,S2235
7548,ABUBAKKAR SITHICK J,Desiya Makkal Sakthi Katchi,1497,21,1518,S2235
7549,MANIVASAGAM S,Bahujan Dravida Party,1392,11,1403,S2235
7550,PANNEERSELVAM O S/O  OYYARAM,Independent,1369,7,1376,S2235
7551,SALEEM,Independent,961,13,974,S2235
7552,SASIKANI K,Independent,896,3,899,S2235
7553,SATHURAGIRI K,Independent,815,12,827,S2235
7554,SIKKANDAR B,Independent,804,19,823,S2235
7555,VIGNESH V,Independent,643,9,652,S2235
7556,PANNERSELVAM O  S/O  OCHATTHEVAR,Independent,564,8,572,S2235
7557,NOTA,None of the Above,6163,132,6295,S2235
7558,SUPRIYA SULE,Nationalist Congress Party – Sharadchandra Pawar,731400,912,732312,S1335
7559,SUNETRA AJITDADA PAWAR,Nationalist Congress Party,573391,588,573979,S1335
7560,MAHESH SITARAM BHAGWAT,Independent,15620,43,15663,S1335
7561,SHAIKH SOYALSHAHA YUNUSSHAHA,Independent,14913,4,14917,S1335
7562,PRIYADARSHANI NANDKUMAR KOKARE,Bahujan Samaj Party,9995,35,10030,S1335
7563,SACHIN SHANKAR AGAWANE,Independent,6633,0,6633,S1335
7564,KAMBLE TRISHALA,Bahujan Samaj Party  (Ambedkar),5032,4,5036,S1335
7565,SUNITA PAWAR,Independent,4150,1,4151,S1335
7566,GAJANAN UTTAM GAWALI (PATIL),Independent,2991,4,2995,S1335
7567,MANOJ BALASAHEB RASAL,Independent,2610,0,2610,S1335
7568,MAHADEV SAHEBRAO KHENGARE - PATIL,Bhartiya Navjawan Sena (Paksha),2412,6,2418,S1335
7569,PRADEEP RAMCHANDRA MANE,Independent,2234,1,2235,S1335
7570,SHIVAJI JAYSING KOKRE,Independent,2161,3,2164,S1335
7571,PROF. NAMDEORAO JADHAV,Independent,2125,9,2134,S1335
7572,RAJENDRA PANDURANG BHOSALE,People’s Union Party,2007,2,2009,S1335
7573,KALYANI SUJITKUMAR WAGHMODE,Independent,1974,1,1975,S1335
7574,DASHRATH NANA RAUT,Bharatiya Praja Surajya Paksha,1828,6,1834,S1335
7575,ANKUSH DNYANESHAWAR PILANE,Independent,1663,0,1663,S1335
7576,SANDIP ABAJI DEOKATE,Independent,1622,2,1624,S1335
7577,DATTATRAY RAMBHAU CHANDARE,Independent,1433,1,1434,S1335
7578,SHAILENDRA ALIAS SANDEEP KARANJAWANE,Independent,1392,0,1392,S1335
7579,SHUBHANGI DHAYGUDE,Independent,1283,9,1292,S1335
7580,DR. SOMNATH ALIAS BALASAHEB ARJUN POL,Independent,1169,0,1169,S1335
7581,ROHIDAS BALASO KONDAKE,Bahujan Republican  Socialist Party,1127,3,1130,S1335
7582,MILIND VITTHAL SHINDE,Independent,1099,0,1099,S1335
7583,SURESHDADA BABURAO VIR,Independent,1012,0,1012,S1335
7584,BAPU PRALHAD PAWAR,Independent,997,1,998,S1335
7585,RAJENDRA MAHADEV BARAKADE,Independent,905,2,907,S1335
7586,UMESH MAHADEV MHETRE,Independent,807,1,808,S1335
7587,SHIVAJI RAMBHAU NANDKHILE,Bharatheeya Jawan Kisan Party,785,4,789,S1335
7588,SHARAD RAM PAWAR,Independent,730,1,731,S1335
7589,LAXMAN RAM KUMBHAR,Dalit Soshit Pichhara Varg  Adhikar Dal,694,2,696,S1335
7590,SHRIDHAR NARAYAN SALVE,Bhim Sena,675,4,679,S1335
7591,BALASO MARUTI DHAPATE,Independent,655,0,655,S1335
7592,VIJAY LAXMAN GHAVALE,Independent,617,3,620,S1335
7593,VISHAL ARUN PAWAR,Independent,553,0,553,S1335
7594,SAVITA BHIMRAO KADALE,Hindustan Janta Party,549,2,551,S1335
7595,VIJAYPRAKASH ANANT KONDEKAR,Independent,301,0,301,S1335
7596,NOTA,None of the Above,9130,21,9151,S1335
7597,SK NURUL ISLAM,All India Trinamool Congress,801542,2220,803762,S2518
7598,REKHA PATRA,Bharatiya Janata Party,468593,1622,470215,S2518
7599,AKHTAR RAHAMAN BISWAS,All India Secular Front,123432,68,123500,S2518
7600,NIRAPADA SARDAR,Communist Party of India  (Marxist),77611,288,77899,S2518
7601,MAFIJUL MOLLA,Independent,11833,0,11833,S2518
7602,PRIYAMA DAS,Independent,6606,14,6620,S2518
7603,MIRAZ MOLLA,Independent,5902,0,5902,S2518
7604,MD ABUL KALAM MOLLA,Bahujan Samaj Party,4451,13,4464,S2518
7605,BIDYUT GAYEN,Independent,3625,9,3634,S2518
7606,IMRAN ALI SARDAR,Bharatheeya Jawan Kisan Party,2548,5,2553,S2518
7607,PIYARUL ISLAM,Independent,2388,3,2391,S2518
7608,SARAVAN SINGH,Independent,2020,1,2021,S2518
7609,DAUD ALI GAZI,Socialist Unity Centre Of India (COMMUNIST),1163,4,1167,S2518
7610,KINKAR KANTI ROY,Independent,1115,3,1118,S2518
7611,BIPUL CHANDRA BISWAS,Mulnibasi Party of India,1070,4,1074,S2518
7612,NOTA,None of the Above,5229,19,5248,S2518
7613,DR. HEMANG JOSHI,Bharatiya Janata Party,865825,7364,873189,S0620
7614,PADHIYAR  JASHPALSINH MAHENDRASINH (BAPU),Indian National Congress,287570,3493,291063,S0620
7615,JADAV AMITKUMAR RAMJIBHAI,Bahujan Samaj Party,7473,56,7529,S0620
7616,RAJESH RATHOD,Independent,5416,53,5469,S0620
7617,ANILBHAI SHARMA,Hindrashtra Sangh,3436,17,3453,S0620
7618,DR. RAHUL VASUDEVBHAI VYAS,Independent,2731,21,2752,S0620
7619,PARMAR MAYURSINH ARVINDSINH,Independent,2122,86,2208,S0620
7620,NILKANTHKUMAR MANSUKHLAL MISTRI,Independent,1748,8,1756,S0620
7621,PARMAR HEMANTKUMAR ARVINDBHAI,Independent,1388,23,1411,S0620
7622,TAPAN DASGUPTA,Socialist Unity Centre Of India (COMMUNIST),1252,23,1275,S0620
7623,ATUL GAMECHI,Independent,1061,23,1084,S0620
7624,PARTHIV VIJAYKUMAR DAVE,Right to Recall Party,1052,5,1057,S0620
7625,NILESH JAGANNATH VASAIKAR,Independent,840,18,858,S0620
7626,DOSHI HARDIK BIPINBHAI,Satyawadi Rakshak Party,643,14,657,S0620
7627,NOTA,None of the Above,17823,565,18388,S0620
7628,TEJASVI SURYA,Bharatiya Janata Party,747780,3050,750830,S1026
7629,SOWMYA REDDY,Indian National Congress,472754,993,473747,S1026
7630,ARUN PRASAD.A,Bahujan Samaj Party,2416,9,2425,S1026
7631,TINTISHA HEMACHANDRA SAGAR,Independent,1962,6,1968,S1026
7632,VATAL NAGARAJ,Kannada Chalavali Vatal Paksha,1857,10,1867,S1026
7633,KEMPEGOWDA,Navabharath Sena,1390,3,1393,S1026
7634,TEJASWINI DHANANJAY,Independent,1147,3,1150,S1026
7635,BALAKRISHNA.M.,Uttama Prajaakeeya Party,1106,4,1110,S1026
7636,JAYAPAL.D,Independent,940,2,942,S1026
7637,RANJITH GOWDA,Independent,859,1,860,S1026
7638,V.RAJKUMAR VCK,Independent,738,2,740,S1026
7639,RAGHUPATHI BHAT,Karnataka Rashtra Samithi,737,1,738,S1026
7640,DR HARISH GOWDA,Independent,555,8,563,S1026
7641,CHETAN CHAMAN,Country Citizen Party,490,2,492,S1026
7642,A . RAJ.,Independent,473,4,477,S1026
7643,K. C. JANARDHAN,Independent,444,8,452,S1026
7644,KANTHAKUMAR.R.,Independent,393,10,403,S1026
7645,KARAVALI MANJUNATH. BE,Rashtriya Samaj Dal (R),308,2,310,S1026
7646,C M. SHABAZ KHAN,Young Star Empowerment Party,295,2,297,S1026
7647,ASGAR A MOHIN.S.M.,Independent,266,3,269,S1026
7648,SUBRAHMANYA KUMAR KUNTIKANAMATA,Independent,234,3,237,S1026
7649,DR.R.SHEKAR THIRUMAVALVAN,Independent,214,1,215,S1026
7650,NOTA,None of the Above,7830,27,7857,S1026
7651,DR. AMOL RAMSING KOLHE,Nationalist Congress Party – Sharadchandra Pawar,697768,924,698692,S1336
7652,ADHALRAO SHIVAJI DATTATREY,Nationalist Congress Party,557138,603,557741,S1336
7653,MANOHAR MAHADU WADEKAR,Independent,28324,6,28330,S1336
7654,DR. ANWAR SHAIKH,Vanchit Bahujan  Aaghadi,17444,18,17462,S1336
7655,RAHUL RAGHUNATH OWHAL,Bahujan Samaj Party,10280,15,10295,S1336
7656,CHANDGUDE VINOD VASANT,Independent,8076,2,8078,S1336
7657,GORAKSH KASABE,Independent,4913,2,4915,S1336
7658,ADV. DR. LAXMAN RAMBHAU DAMSE,Bharat Adivasi Party,4125,11,4136,S1336
7659,GAIKWAD NILOBA CHANGADEO,Independent,3569,2,3571,S1336
7660,UMESH MAHADEV MHETRE,Independent,3499,0,3499,S1336
7661,ADV.SWAPNIL BHAUSAHEB SHELAR,Independent,2667,0,2667,S1336
7662,AMOL VILAS PACHUNDKAR,Independent,2386,2,2388,S1336
7663,ASLAM ISAK BAGWAN,Lok Sena Party,2348,2,2350,S1336
7664,KAMBLE TRIMBAK NARAYAN,Baliraja Party,2223,4,2227,S1336
7665,SUBASH KASHINATH SARODE,Independent,2161,0,2161,S1336
7666,CHAAYA SANJAY JAGDALE-SOLANKE,Independent,1823,7,1830,S1336
7667,SUSHIL DNYANDEV KANSE,Independent,1731,1,1732,S1336
7668,NARAYAN PRABHAKAR ANKUSHE,Bharatheeya Jawan Kisan Party,1279,5,1284,S1336
7669,BHOR VIKAS ROHIDAS,Independent,1145,2,1147,S1336
7670,DADA ALIAS VIKAS SURESH KASBE,Independent,1105,1,1106,S1336
7671,SURAJ CHANDRAKANT GAIKWAD,Independent,936,2,938,S1336
7672,SWAPNIL DHANAJI LONDHE,Bhim Sena,913,1,914,S1336
7673,AMAR MACHINDRA BORHADE,Independent,887,1,888,S1336
7674,RAVINDRA MOTIRAM SIRSAM,Independent,870,0,870,S1336
7675,TUKARAM NAMDEO DAPHAL,Sainik Samaj Party,862,20,882,S1336
7676,PANDURANG BHAGWAN WAGHOLE,Independent,818,1,819,S1336
7677,SANJAY LAXMAN PADWAL,Bhartiya Navjawan Sena (Paksha),779,5,784,S1336
7678,HARIDAS CHANDAR BHISE,Bharatiya Lokvikas Party,721,2,723,S1336
7679,SALIM BABA SAYYAD,Independent,671,0,671,S1336
7680,PRAKASH SUKHADEO JAMDHADE,Independent,602,1,603,S1336
7681,WAKHARE PRADIP PANDURANG,Independent,574,0,574,S1336
7682,RAHUL ARJUN HORE,Independent,526,0,526,S1336
7683,NOTA,None of the Above,9634,27,9661,S1336
7684,KAUSHALENDRA KUMAR,Janata Dal  (United),557054,2368,559422,S0429
7685,DR. SANDEEP SAURAV,Communist Party of India  (Marxist-Leninist)  (Liberation),388052,2256,390308,S0429
7686,SUDHIR KUMAR,Sanyukt Kisan Vikas Party,25286,5,25291,S0429
7687,SURENDRA PRASAD,Al-Hind Party,18571,5,18576,S0429
7688,SHASHI KUMAR,Samaj Shakti Party,18472,8,18480,S0429
7689,PRAMOD KUMAR NIRALA,Bahujan Samaj Party,15233,99,15332,S0429
7690,AJEET KUMAR,Independent,14746,4,14750,S0429
7691,VINAY PRATAP SINGH,Rashtriya Sanatan Party,9593,9,9602,S0429
7692,SANJAY RAJESH,Karpoori Janta Dal,7878,9,7887,S0429
7693,SUDHIR DAS,Independent,6804,2,6806,S0429
7694,KANHAIYA LAL YADAV,Jagrook Janta Party,6665,27,6692,S0429
7695,SANYUKTA KUMARI,Independent,6232,6,6238,S0429
7696,AJIT KUMAR,Independent,5515,5,5520,S0429
7697,SHYAM SUNDAR PRASAD,Independent,3922,10,3932,S0429
7698,RAMESH KUMAR,Naki Bharatiya Ekta Party,3840,5,3845,S0429
7699,KISLAY KUMAR,Independent,3599,3,3602,S0429
7700,KESHO JAMADAR,Peoples Party of India (Democratic),3369,18,3387,S0429
7701,SURENDER SINGH,Independent,3341,4,3345,S0429
7702,DILIP KUMAR,Moolniwasi Samaj Party,2724,5,2729,S0429
7703,NAND KISHOR PARASAD,Pragatisheel Magahi Samaj,2456,12,2468,S0429
7704,NISHA RANJAN,Samata Party,2397,18,2415,S0429
7705,SHASHIRANJAN SUMAN,Independent,2331,9,2340,S0429
7706,GHANSHYAM PRASAD SINGH,Independent,2108,2,2110,S0429
7707,KUMAR HARI CHARAN SINGH YADAV,Bharatiya Momin Front,1971,9,1980,S0429
7708,MUNNA KUMAR,Sankhyanupati Bhagidari Party,1937,12,1949,S0429
7709,MUNNA KUMAR,Samajwadi Lok Parishad,1867,13,1880,S0429
7710,PAWAN KUMAR,Independent,1595,2,1597,S0429
7711,PUJA DEVI,Independent,1491,14,1505,S0429
7712,CHANDRA KISHOR PRASAD YADAV,Independent,1177,1,1178,S0429
7713,NOTA,None of the Above,19110,107,19217,S0429
7714,DR. LATA WANKHEDE,Bharatiya Janata Party,786160,1819,787979,S125
7715,CHANDRA BHUSAN SINGH BUNDELA 'GUDDU RAJA',Indian National Congress,316059,698,316757,S125
7716,BHAGWATI PRASAD JATAV,Bahujan Samaj Party,16592,44,16636,S125
7717,BHEEKAM SINGH KUSHWAHA,Mahanwadi Party,5778,6,5784,S125
7718,RAM BHJAN BANSAL,Samata Party,3149,4,3153,S125
7719,MOHAMAD AARIF MAKRANI,Independent,2888,0,2888,S125
7720,SANGRAM SINGH YADAV,Independent,2819,5,2824,S125
7721,DHARMENDRA BANPURIYA,Independent,1621,3,1624,S125
7722,TOSHMANI PANTHI (KANNA),Independent,1293,6,1299,S125
7723,SURESH BANSAL,Bhartiya Shakti Chetna Party,1147,4,1151,S125
7724,LAXMI KUSHWAHA,Pichhara Samaj Party United,947,5,952,S125
7725,DR. RAMAVATAR SHARMA,Socialist Unity Centre Of India (COMMUNIST),924,4,928,S125
7726,AHIRWAR RAJKUMAR THEKEDAAR,Independent,914,3,917,S125
7727,NOTA,None of the Above,7641,16,7657,S125
7728,NALIN SOREN,Jharkhand Mukti Morcha,542299,5071,547370,S272
7729,SITA MURMU,Bharatiya Janata Party,520714,4129,524843,S272
7730,MAHASHON MURMU,Independent,21371,1,21372,S272
7731,BABYLATA TUDU,Independent,19275,85,19360,S272
7732,RAJESH KISKU,Communist Party of India,11484,22,11506,S272
7733,DR. SRILAL KISKU,Independent,9414,2,9416,S272
7734,PARESH MARANDI,Bahujan Samaj Party,7713,20,7733,S272
7735,ANIL TUDU,Lokhit Adhikar Party,6811,7,6818,S272
7736,SUSHANTI HEMBROM,Independent,5150,2,5152,S272
7737,MANOJ HEMBROM,Independent,4814,2,4816,S272
7738,BIREN MOHLI,Independent,4416,2,4418,S272
7739,RAJU EMANUEL MURMU,Ambedkarite Party of India,3056,4,3060,S272
7740,KAMISHNAR MURMU,Independent,2509,7,2516,S272
7741,BAGHRAI SOREN,Independent,2255,1,2256,S272
7742,SANJAY TUDU,Independent,2171,3,2174,S272
7743,MUNNI HANSDA,Samata Party,1753,5,1758,S272
7744,NIRMAL SOREN,Independent,1707,6,1713,S272
7745,ALESH HANSDA,Indian National Socialistic Action Forces,1666,8,1674,S272
7746,JONATHAN MARDI,Peoples Party of India (Democratic),1650,1,1651,S272
7747,NOTA,None of the Above,4453,73,4526,S272
7748,RAKESH RATHOR,Indian National Congress,530467,671,531138,S2430
7749,RAJESH VERMA,Bharatiya Janata Party,441066,431,441497,S2430
7750,MAHENDRA SINGH YADAV,Bahujan Samaj Party,99284,80,99364,S2430
7751,MO. KASHIF ANSARI,Apna Dal (Kamerawadi),7585,1,7586,S2430
7752,LEKHRAJ LODHI,Aazad Samaj Party (Kanshi Ram),6734,0,6734,S2430
7753,VIDYAWATI GAUTAM,Independent,4193,1,4194,S2430
7754,CHANDRA SHEKHAR VERMA,Rashtriya Shoshit Samaj Party,2429,0,2429,S2430
7755,RAM ADHAR VERMA,Sardar Patel Siddhant Party,2114,1,2115,S2430
7756,NOTA,None of the Above,6954,4,6958,S2430
7757,DR RAJEEV BHARDWAJ,Bharatiya Janata Party,622482,10311,632793,S081
7758,ANAND SHARMA,Indian National Congress,374346,6552,380898,S081
7759,REKHA CHAUDHARY,Bahujan Samaj Party,7478,275,7753,S081
7760,ADVOCATE SANJAY SHARMA,Independent,2304,15,2319,S081
7761,DR KEHAR SINGH,Independent,2129,49,2178,S081
7762,JEEVAN KUMAR,Akhil Bhartiya Parivar Party,1441,35,1476,S081
7763,NARAIN SINGH DOGRA,Himachal Janta Party,1125,46,1171,S081
7764,BHUVNESH KUMAR,Rashtriya Devbhumi Party,701,55,756,S081
7765,DEV RAJ BHARDWAJ,Rashtriya Samaj Dal (R),588,19,607,S081
7766,ACHAL SINGH,Independent,491,54,545,S081
7767,NOTA,None of the Above,6260,112,6372,S081
7768,SMT. HIMADRI SINGH,Bharatiya Janata Party,709477,1666,711143,S1212
7769,PHUNDE LAL SINGH MARKO,Indian National Congress,312833,970,313803,S1212
7770,ANIL SINGH DHURVEY,Gondvana Gantantra Party,35186,92,35278,S1212
7771,DHANI RAM KOL,Bahujan Samaj Party,21792,62,21854,S1212
7772,SAMAR SHAH SINGH GOND,Communist Party of India,19861,22,19883,S1212
7773,KESHKALI BAIGA,Independent,10042,29,10071,S1212
7774,GUNJAN SINGH,Independent,7460,19,7479,S1212
7775,RAVIKARAN SINGH DHURVE,Bhartiya Shakti Chetna Party,4964,11,4975,S1212
7776,AMRIT LAL SINGH UIKEY,Peoples Party of India (Democratic),4701,21,4722,S1212
7777,DR. DURGA WATI BHARIA,Chhattisgarh Vikas Ganga Rashtriya Party,3425,19,3444,S1212
7778,NOTA,None of the Above,19341,20,19361,S1212
7779,BALYA MAMA - SURESH GOPINATH MHATRE,Nationalist Congress Party – Sharadchandra Pawar,498199,1265,499464,S1323
7780,KAPIL MORESHWAR PATIL,Bharatiya Janata Party,431907,1436,433343,S1323
7781,NILESH BHAGWAN SAMBARE,Independent,230254,1163,231417,S1323
7782,KANCHAN VINAYAK VAKHARE,New Rashtriya Samaj Party,24607,18,24625,S1323
7783,TARA PINTYA WAGHE,Independent,6908,0,6908,S1323
7784,MUMATAZ ABDULSATTAR ANSARI,Bahujan Samaj Party,6801,21,6822,S1323
7785,MANISHA SANTOSH GONDHALE,Independent,5120,0,5120,S1323
7786,MANOJ GOVAR TURE,Independent,4896,1,4897,S1323
7787,JAHID MURABTAR ANSARI,Independent,4879,3,4882,S1323
7788,CHANDRAKANT RAMBHAJI MOTE,Independent,3429,4,3433,S1323
7789,RAHUL ASHOK KATHOLE,Independent,3131,4,3135,S1323
7790,ASHOK BHIKU BAHADARE,Sanyukt Bharat Paksh,2044,3,2047,S1323
7791,SURESH PANDAGALE,Apni Prajahit Party,1997,16,2013,S1323
7792,MILIND KASHINATH KAMBLE,Independent,1843,18,1861,S1323
7793,KHAN MOHD AKARAM ABDUL HANAN,All India Majlis-E-Ittehadul Muslimeen,1739,2,1741,S1323
7794,DANISH EZAZ AH. SHAIKH,Bahujan Maha Party,1580,6,1586,S1323
7795,HARSHAD RAMESH MHATRE,Independent,1568,0,1568,S1323
7796,MUTKIRI SHANKAR NAGESH,Independent,1445,0,1445,S1323
7797,KAPIL JAYHIND PATIL,Independent,1237,5,1242,S1323
7798,SAIFAN CHAND PATHAN,Bhartiya Manavta Party,1188,1,1189,S1323
7799,RANJANA RAVI TRIBHUWAN,Independent,1082,3,1085,S1323
7800,MOHD. KALEEM ANSARI,Peoples Party of India (Democratic),934,3,937,S1323
7801,WASEEM TUFAIL SIDDIQUI,Independent,803,2,805,S1323
7802,SURESH SITARAM MHATRE,Independent,706,1,707,S1323
7803,SONALI ASHOK GANGAWANE,Independent,698,0,698,S1323
7804,AAPPA - VISHAL VIJAY MORE,Independent,598,3,601,S1323
7805,PROF. AMEERUL HASAN SAYYED,Independent,479,2,481,S1323
7806,NOTA,None of the Above,9266,81,9347,S1323
7807,PRALHAD JOSHI,Bharatiya Janata Party,713649,2582,716231,S1011
7808,VINOD ASOOTI,Indian National Congress,617616,1291,618907,S1011
7809,SHAKEELAHMAD.D.MULLA,Independent,5866,6,5872,S1011
7810,S. S. PATIL,Independent,5153,8,5161,S1011
7811,RAJU ANANTSA NAIKWADI,Independent,3601,0,3601,S1011
7812,JAVEED AHAMED BELGAUMKAR.,Naki Bharatiya Ekta Party,3551,7,3558,S1011
7813,SHARANABASAV GONAVAR,Socialist Unity Centre Of India (COMMUNIST),1148,19,1167,S1011
7814,BALANAGOUDRA MALLIKARJUNAGOUDA,Independent,986,1,987,S1011
7815,TAKAPPA YALLAPPA KALAL,Prahar Janshakti Party,901,4,905,S1011
7816,BUGADI BASAVALINGAPPA IRAPPA,Uttama Prajaakeeya Party,796,4,800,S1011
7817,NAGARAJ. KARENNAVAR.,Karnataka Rashtra Samithi,553,2,555,S1011
7818,PRAVEEN H. H.,Independent,545,3,548,S1011
7819,DR. GURAPPA H IMRAPUR,Independent,510,4,514,S1011
7820,BANKAPUR SHOUKATALI,Tipu Sultan Party,464,9,473,S1011
7821,VINOD DASHARATH GHODKE,"Proutist Bloc, India",409,2,411,S1011
7822,VENKATESH PRASAD. H,Indian Labour Party (Ambedkar Phule),334,3,337,S1011
7823,MOHAMMED ISMAIL MUKTI,Bharatiya Prajagala Kalyana Paksha,313,4,317,S1011
7824,NOTA,None of the Above,6126,21,6147,S1011
7825,DULU MAHATO,Bharatiya Janata Party,782423,6749,789172,S277
7826,ANUPAMA SINGH,Indian National Congress,452358,5231,457589,S277
7827,MD. EKLAK ANSARI,Independent,78885,768,79653,S277
7828,JAGDISH RAWANI,Independent,27499,136,27635,S277
7829,JANAK SAH GOND,Independent,12761,3,12764,S277
7830,MD. ZAHIRUDDIN KHAN,Independent,6499,1,6500,S277
7831,MOHAN SINGH,Bahujan Samaj Party,5594,45,5639,S277
7832,TULSI MAHTO,Independent,5371,4,5375,S277
7833,KAMASHEVAR PRA. VERMA,Independent,4002,2,4004,S277
7834,SUNAINA KINNAR,Independent,3430,32,3462,S277
7835,AKBAR ALI,Akhil Bhartiya Parivar Party,3031,10,3041,S277
7836,KRISHNA CHANDRA SINGH RAJ,Samata Party,2818,3,2821,S277
7837,ANINDITA DAS,Independent,2655,19,2674,S277
7838,REZAUL HAQUE,Lokhit Adhikar Party,2642,7,2649,S277
7839,LAKSHMI DEVI,Independent,2600,5,2605,S277
7840,UMESH PASWAN,Independent,2554,6,2560,S277
7841,MOHAMMAD FAISHAL KHAN,Independent,1994,2,1996,S277
7842,RAJIB TIWARI,Socialist Unity Centre Of India (COMMUNIST),1880,10,1890,S277
7843,DEEPAK KUMAR DAS,Peoples Party of India (Democratic),1720,15,1735,S277
7844,NITAI DUTTA,Independent,1695,48,1743,S277
7845,SANJAY KUMAR GIRI,Akhil Bharat Hindu Mahasabha,1617,10,1627,S277
7846,PERWEZ NEYYAR,Aazad Samaj Party (Kanshi Ram),1157,4,1161,S277
7847,TRIDEV KR MAHTO,Independent,1126,18,1144,S277
7848,MOHAMMAD TAFAZUL HUSSAIN,Independent,681,0,681,S277
7849,PREM PRAKASH PASWAN,Independent,516,17,533,S277
7850,NOTA,None of the Above,7202,152,7354,S277
7851,PRATAP CHANDRA SARANGI,Bharatiya Janata Party,561590,2275,563865,S186
7852,LEKHASRI SAMANTSINGHAR,Biju Janata Dal,415917,792,416709,S186
7853,SHRIKANTA JENA,Indian National Congress,236081,926,237007,S186
7854,RAJAT KUMAR BEHERA,Bahujan Samaj Party,2913,7,2920,S186
7855,GOBINDA CHANDRA BHOI,National Apni Party,2640,0,2640,S186
7856,SURYAKANTA DASMOHAPATRA,Independent,2156,5,2161,S186
7857,MAHAMEGHABAHAN AIRA KHARABELA SWAIN,Independent,1863,5,1868,S186
7858,PRAMOD KUMAR PATTAYAT,Independent,1637,2,1639,S186
7859,BIREN PUHAN,Krupaa Party,1450,2,1452,S186
7860,DEEPAK SANKAR THAKUR GIRI,Independent,1191,3,1194,S186
7861,AKHIL KUMAR MOHANTA,Independent,829,1,830,S186
7862,NOTA,None of the Above,7333,17,7350,S186
7863,CHINTAMANI MAHARAJ,Bharatiya Janata Party,712172,1028,713200,S261
7864,SHASHI SINGH KORAM,Indian National Congress,647329,1049,648378,S261
7865,DR. L. S. UDAY SINGH,Gondvana Gantantra Party,15626,25,15651,S261
7866,SANJAY KUMAR,Bahujan Samaj Party,15182,17,15199,S261
7867,RAMADHAR SINGH,Independent,10857,4,10861,S261
7868,PRINCE ABHISHEK KUJUR,Independent,6803,12,6815,S261
7869,URMILA SINGH,Independent,5779,5,5784,S261
7870,ARVIND KACHHAP,Independent,4166,18,4184,S261
7871,KANTA MINJ,Akhil Bhartiya Parivar Party,4008,8,4016,S261
7872,JEROME MINJ,Bharat Adivasi Party,3035,25,3060,S261
7873,NOTA,None of the Above,28107,14,28121,S261
7874,RAJEEV RAI,Samajwadi Party,501407,1724,503131,S2470
7875,DR. ARVIND RAJBHAR,Suheldev Bharatiya Samaj Party,339416,772,340188,S2470
7876,BALKRISHNA CHAUHAN,Bahujan Samaj Party,208938,466,209404,S2470
7877,LILAWATI RAJBHAR,Moolniwasi Samaj Party,47520,7,47527,S2470
7878,PAWAN KUMAR CHAUHAN,Independent,7067,10,7077,S2470
7879,VINOD KUMAR RAI,Communist Party of India,6987,6,6993,S2470
7880,ROLI GUPTA,Akhil Bhartiya Hamara Samaj Party,4211,14,4225,S2470
7881,VIRENDRA,Rashtriya Jantantrik Bharat Vikas Party,2344,3,2347,S2470
7882,VIJAY,Socialist Unity Centre Of India (COMMUNIST),2240,1,2241,S2470
7883,AWADHESH KUMAR CHAUHAN,Janta Kranti Party (Rashtravadi),2211,28,2239,S2470
7884,SATISH CHAND PRAJAPATI FAUJI,Samajhdar Party,1918,3,1921,S2470
7885,MADAN RAJBHAR,Mang Samaj Party,1895,10,1905,S2470
7886,SAUDAGER,Independent,1892,0,1892,S2470
7887,RAJENDRA RAM,Independent,1649,0,1649,S2470
7888,YAKUB ANSARI,Peace Party,1568,5,1573,S2470
7889,PREM CHAND,Pragatisheel Manav Samaj Party,1559,2,1561,S2470
7890,SANTOSH KUMAR GUPTA,Janlok Vikas Party,1473,0,1473,S2470
7891,JYOTIRMA PATHAK,Independent,1199,5,1204,S2470
7892,BADRI NATH,Independent,1164,6,1170,S2470
7893,PREMCHAND NAYAK,Independent,1116,1,1117,S2470
7894,RAMNARESH YADAV,Jan Raajya Party,881,4,885,S2470
7895,RAJIV KUMAR SINGH,Independent,855,2,857,S2470
7896,ISHWAR DAYAL SINGH SETH,Bhartiya Sabka Dal,827,14,841,S2470
7897,PRAGYESH KUMAR,Independent,816,2,818,S2470
7898,RAMVACHAN,Sardar Patel Siddhant Party,771,2,773,S2470
7899,RAJENDRA AGRAWAL,Independent,729,1,730,S2470
7900,GOPAL SINGH,Azad Adhikar Sena,729,8,737,S2470
7901,ISMAIL ANSARI,Aawami Pichhada Party,592,2,594,S2470
7902,NOTA,None of the Above,3487,31,3518,S2470
7903,JASHUBHAI BHILUBHAI RATHVA,Bharatiya Janata Party,791727,4862,796589,S0621
7904,SUKHRAMBHAI HARIYABHAI RATHWA,Indian National Congress,394433,3379,397812,S0621
7905,BHIL SOMABHAI GOKALBHAI,Bahujan Samaj Party,16021,72,16093,S0621
7906,RATHVA FURAKANBHAI BALJIBHAI,Malwa Congress,11091,70,11161,S0621
7907,TADVI RANCHHODBHAI,Bharatiya Bahujan Congress,8292,52,8344,S0621
7908,RATHVA MUKESHBHAI NURABHAI,Independent,8032,33,8065,S0621
7909,NOTA,None of the Above,29394,261,29655,S0621
7910,T R BAALU,Dravida Munnetra Kazhagam,755671,2940,758611,S225
7911,G PREMKUMAR,All India Anna Dravida Munnetra Kazhagam,270549,1033,271582,S225
7912,V N VENUGOPAL,Tamil Maanila Congress  (Moopanar),209183,927,210110,S225
7913,V RAVICHANDRAN,Naam Tamilar Katchi,139931,302,140233,S225
7914,K PRABAKARAN,Bahujan Samaj Party,8115,74,8189,S225
7915,M S ARUMUGAM,Independent,3695,4,3699,S225
7916,V SUDHAVALLI,Aravor Munnetra Kazhagam,3659,35,3694,S225
7917,S AMBETHKUMAR,Mahathma Makkal Munnetra Kazhakam,2211,9,2220,S225
7918,M ASHOK KUMAR,Independent,1696,8,1704,S225
7919,S SIVAKUMAR,Veerath Thiyagi Viswanathadoss Thozhilalarkal Katchi,1349,3,1352,S225
7920,AYODHI LAKSHMANAN,Independent,1255,4,1259,S225
7921,S CHITTIBABU,Naadaalum Makkal Katchi,1238,3,1241,S225
7922,C ARAVIND,Desiya Makkal Sakthi Katchi,959,11,970,S225
7923,GOPI DEEPAK,Independent,878,5,883,S225
7924,KARTHIK KUMAR P C,Independent,866,1,867,S225
7925,J MOHANRAJ,Jebamani Janata,817,5,822,S225
7926,DR S PRAVEEN,Independent,791,8,799,S225
7927,I MOHAMED YASEEN,Thakkam Katchi,668,1,669,S225
7928,K PALANIYAPPAN,Tamizhaga Murpokku Makkal Katchi,613,4,617,S225
7929,S PRABHU,Independent,513,1,514,S225
7930,P BASKARAN,Independent,493,1,494,S225
7931,P HARIDAS,Independent,458,2,460,S225
7932,C A JAYARAMAN,Independent,445,2,447,S225
7933,G RAMKUMAR,Independent,426,0,426,S225
7934,N MANIKKAM,Independent,402,1,403,S225
7935,M PREMKUMAR,Independent,393,1,394,S225
7936,S MUNIKUMAR,Samaniya Makkal Nala Katchi,393,1,394,S225
7937,M SARAVANAN,Independent,385,0,385,S225
7938,A JINNA MOHAMMED,Independent,382,6,388,S225
7939,S SIVARAMAN,Independent,340,3,343,S225
7940,C PREMKUMAR,Independent,313,3,316,S225
7941,NOTA,None of the Above,26294,156,26450,S225
7942,OMPRAKASH BHUPALSINH ALIAS PAVAN RAJENIMBALKAR,Shiv Sena (Uddhav Balasaheb Thackrey),743597,5155,748752,S1340
7943,ARCHANA RANAJAGJITSINH PATIL,Nationalist Congress Party,416699,2207,418906,S1340
7944,ANDHALKAR BHAUSAHEB RAOSAHEB,Vanchit Bahujan  Aaghadi,33221,181,33402,S1340
7945,GOVARDHAN SUBRAO NIMBALKAR,Independent,18947,19,18966,S1340
7946,DNYANESHWAR NAGANATHRAO KOLI,Samata Party,6459,13,6472,S1340
7947,KAKASAHEB SANDIPAN KHOT,Independent,5707,8,5715,S1340
7948,SANJAYKUMAR BHAGWAT WAGHMARE,Bahujan Samaj Party,5525,90,5615,S1340
7949,KAKA FULCHAND KAMBLE,Independent,4807,4,4811,S1340
7950,RAM HANUMANT SHENDAGE,Independent,3255,8,3263,S1340
7951,UMAJI PANDURANG GAIKWAD,Independent,3089,6,3095,S1340
7952,GORE NETAJI NAGNATH,Desh Janhit Party,2314,22,2336,S1340
7953,HANUMANT LAXMAN BONDAR,Independent,2170,2,2172,S1340
7954,NAVNATH DASHRATH UPALEKAR,Independent,2099,9,2108,S1340
7955,SIDDIK IBRAHIM BAUDIWALE ALIAS GOLABHAI,All India Majlis-E-Ittehadul Muslimeen,2052,8,2060,S1340
7956,ARJUN (DADA) SALGAR,Independent,1923,12,1935,S1340
7957,ARYANRAJE KISANRAO SHINDE,Rashtriya Samaj Dal (R),1852,35,1887,S1340
7958,SHAIKH NAUSHAD IQBAL,Swarajya Shakti Sena,1671,15,1686,S1340
7959,SHAMRAO HARIBHAU PAWAR,Samnak Janta Party,1492,17,1509,S1340
7960,YOGIRAJ ANANTA TAMBE,Independent,1326,10,1336,S1340
7961,SOMNATH NANASAHEB KAMBLE,Independent,1262,6,1268,S1340
7962,BHORE NITIN KHANDU,Independent,1195,9,1204,S1340
7963,MANOHAR ANANDRAO PATIL,Independent,1182,8,1190,S1340
7964,NAVNATH VISHWANATH DUDHAL,Vishva Shakti Party,1123,12,1135,S1340
7965,NITESH SHIVAJI PAWAR,Hindrashtra Sangh,1060,19,1079,S1340
7966,ADV. VISHVJEET VIJAYKUMAR SHINDE,Aadarsh Sangram Party,855,10,865,S1340
7967,SHAYANI NAVANATH JADHAV,Independent,779,3,782,S1340
7968,NITIN NAGNATH GAIKWAD,Independent,729,2,731,S1340
7969,ADV. BHAUSAHEB ANIL BELURE,Independent,675,2,677,S1340
7970,VILAS BHAGWAT GHADGE,Independent,604,6,610,S1340
7971,SAMEERSINGH RAMESHCHANDRA SALVI,Independent,591,3,594,S1340
7972,RAJKUMAR SAHEBRAO PATIL,Independent,589,4,593,S1340
7973,NOTA,None of the Above,4250,48,4298,S1340
7974,BRIJENDRA SINGH OLA,Indian National Congress,541203,11965,553168,S204
7975,SHUBHKARAN CHOUDHARY,Bharatiya Janata Party,523669,11264,534933,S204
7976,SHEKHAWAT RAJENDRA SINGH,Independent,7389,301,7690,S204
7977,BANSHIDHAR,Bahujan Samaj Party,6679,188,6867,S204
7978,DURGA PRASAD MEENA,Ambedkarite Party of India,5440,57,5497,S204
7979,ALTIF,Independent,2025,25,2050,S204
7980,SATYANARAYAN,Bheem Tribal Congress,1127,23,1150,S204
7981,HAZARI LAL,Bahujan Kranti Party (Marxwad-Ambedkarwad),922,18,940,S204
7982,NOTA,None of the Above,6454,178,6632,S204
7983,ASHOK KUMAR YADAV,Bharatiya Janata Party,552705,723,553428,S046
7984,MD ALI ASHRAF FATMI,Rashtriya Janata Dal,400909,574,401483,S046
7985,SHIV BODHAN SAHU,Independent,13365,5,13370,S046
7986,BIKASH KUMAR,Bahujan Samaj Party,7197,26,7223,S046
7987,PRIYE RANJAN,Independent,7046,4,7050,S046
7988,VAIDYANATH YADAV,Peoples Party of India (Democratic),4980,3,4983,S046
7989,SARFARAJ ALAM,Akhil Bhartiya Parivar Party,4620,3,4623,S046
7990,MD WAQUAR SIDDIQUI,All India Majlis-E-Ittehadul Muslimeen,4492,6,4498,S046
7991,MOHAN SHARMA,Rashtriya Jansambhavna Party,4460,4,4464,S046
7992,ABU BAKAR RAHMANI,Country Citizen Party,2095,2,2097,S046
7993,UDAY MANDAL,Samata Party,1998,9,2007,S046
7994,KUL BHUSHAN PRASAD,Loktantrik Lok Rajyam Party,1780,3,1783,S046
7995,NOTA,None of the Above,20691,28,20719,S046
7996,DR BHOLA SINGH,Bharatiya Janata Party,594040,3270,597310,S2414
7997,SHIVRAM,Indian National Congress,321043,1133,322176,S2414
7998,GIRISH CHANDRA,Bahujan Samaj Party,116876,548,117424,S2414
7999,RAJESH TUREHA,Rishivadi Karm Sheel Young Parmarthi Party,4391,10,4401,S2414
8000,SONAM BHARTI,Independent,3558,42,3600,S2414
8001,PRADEEP KUMAR,Independent,2547,16,2563,S2414
8002,NOTA,None of the Above,6870,55,6925,S2414
8003,HARENDRA SINGH MALIK,Samajwadi Party,469804,917,470721,S243
8004,SANJEEV KUMAR BALYAN,Bharatiya Janata Party,443815,2234,446049,S243
8005,DARA SINGH PRAJAPATI,Bahujan Samaj Party,143323,384,143707,S243
8006,SUNIL TYAGI,Independent,7131,36,7167,S243
8007,KAVITA,Rashtrawadi Janlok Party (Satya),1970,30,2000,S243
8008,SHASHIKANT SHAMAR,Independent,1429,2,1431,S243
8009,BIRBAL SINGH,Vishal Janta Party,1419,2,1421,S243
8010,NEEL KUMAR,Jai Samta Party,858,3,861,S243
8011,RESHU SHARMA,Independent,679,5,684,S243
8012,ANKUR,Independent,362,10,372,S243
8013,MANUJ VERMA,Independent,333,7,340,S243
8014,NOTA,None of the Above,3884,32,3916,S243
8015,PRADEEP KUMAR SINGH,Bharatiya Janata Party,599118,1028,600146,S049
8016,SHAHNAWAZ,Rashtriya Janata Dal,578904,1148,580052,S049
8017,SHATRUGHAN PRASAD SUMAN,Independent,13697,49,13746,S049
8018,MD GHOUSUL AZAM,Bahujan Samaj Party,12672,18,12690,S049
8019,MD. MOBINUL HAQUE,Independent,12005,3,12008,S049
8020,MD. ISMAIL,Bharatiya Momin Front,7353,1,7354,S049
8021,AKHILESH KUMAR,Independent,5086,34,5120,S049
8022,MUSHTAK ALAM,Independent,4897,2,4899,S049
8023,ZAWED AKHTAR,The National Road Map Party of India,3037,4,3041,S049
8024,NOTA,None of the Above,13438,66,13504,S049
8025,JAI PRAKASH,Bharatiya Janata Party,485745,1053,486798,S2431
8026,USHA VERMA,Samajwadi Party,457553,1389,458942,S2431
8027,BHIMRAO AMBEDKAR,Bahujan Samaj Party,122334,295,122629,S2431
8028,SHIVE KUMAR,Independent,4897,1,4898,S2431
8029,SHYAM  KUMAR,Peoples Party of India (Democratic),4196,4,4200,S2431
8030,SUNIL KUMAR VERMA,Independent,3819,2,3821,S2431
8031,INDRAPAL PASI,Justice Party,2945,1,2946,S2431
8032,MUNNA LAL,Naari Nar Rakshak Party,1588,1,1589,S2431
8033,OM PRAKASH,Independent,1559,2,1561,S2431
8034,AWADESH KUMAR,Independent,1420,4,1424,S2431
8035,PRADEEP KUMAR,Bhartiya Krishak Dal,1349,5,1354,S2431
8036,BRAHMA PRASAD,Lok Jan Sangharsh Party,1139,1,1140,S2431
8037,NOTA,None of the Above,8778,36,8814,S2431
8038,PRANITI SUSHILKUMAR SHINDE,Indian National Congress,618350,1875,620225,S1342
8039,RAM VITTHAL SATPUTE,Bharatiya Janata Party,544770,1258,546028,S1342
8040,AATISH MOHAN BANSODE,Independent,10493,14,10507,S1342
8041,BABLU SIDRAM GAIKWAD,Bahujan Samaj Party,5236,32,5268,S1342
8042,SHRIVIDYADURGADEVI MAULAPPA KURANE,Independent,3489,4,3493,S1342
8043,RAMESH BHIMRAO SHIKHARE,Independent,3146,0,3146,S1342
8044,PROF DR ARJUN GENA OHOL,Bahujan Mukti Party,2651,3,2654,S1342
8045,BHANTENAAGAMURTI MOULAPPA KURANE,Independent,1547,7,1554,S1342
8046,SUNILKUMAR TUKARAM SHINDE,Independent,1478,2,1480,S1342
8047,YUGANDHAR CHANDRAKANT THOKALE,Peoples Party of India (Democratic),1125,0,1125,S1342
8048,PARMESHWAR PANDURANG GEJAGE,Independent,885,1,886,S1342
8049,ADV VIKRAM UTTAM KASABE,Independent,843,3,846,S1342
8050,UGHADE VIJAYKUMAR BHAGWAN,Independent,832,1,833,S1342
8051,KUMAR CHANDRAKANT LONDHE,Baliraja Party,678,1,679,S1342
8052,KRISHNA NAGNATH BHISE,Independent,561,1,562,S1342
8053,ANNA SUKHADEV MASKE,Independent,496,5,501,S1342
8054,MAHASIDDHA TUKARAM GAYAKWAD,Independent,406,3,409,S1342
8055,SUDARSHAN RAYCHAND KHANDARE,Independent,400,1,401,S1342
8056,SONAVANE SHIVAJI CHANDRAKANT,Independent,394,0,394,S1342
8057,SACHIN SHAHU MASKE,Independent,389,0,389,S1342
8058,PROF. DR. SUBHASH KHANDERAO GAIKWAD,Independent,379,1,380,S1342
8059,NOTA,None of the Above,2713,12,2725,S1342
8060,M.K. VISHNUPRASAD,Indian National Congress,450401,4652,455053,S2226
8061,P. SIVAKOZHUNDU,Desiya Murpokku Dravida Kazhagam,267707,1450,269157,S2226
8062,THANKAR BACHAN,Pattali Makkal Katchi,202372,2872,205244,S2226
8063,V. MANIVASAGAN,Naam Tamilar Katchi,56863,561,57424,S2226
8064,S. ARIVUDAINAMBI,Anti Corruption Dynamic Party,6479,21,6500,S2226
8065,A. BALAJI,Independent,5440,10,5450,S2226
8066,V.THANIGAISELVAN,Bahujan Samaj Party,3917,54,3971,S2226
8067,K. MAYAKRISHNAN,Veerath Thiyagi Viswanathadoss Thozhilalarkal Katchi,3696,6,3702,S2226
8068,SU.VA. DHATSHANAMOORTHY,Independent,3414,5,3419,S2226
8069,S. RAMALINGAM,Independent,3208,8,3216,S2226
8070,G. PICHAMUTHU,Independent,2186,8,2194,S2226
8071,R. ANANDHI,Independent,1677,19,1696,S2226
8072,S. CHAKKARAVARTHY,Independent,1484,4,1488,S2226
8073,R. SRINIVASAN,Independent,1352,11,1363,S2226
8074,V. DAKSHANAAMURTHY,Independent,1276,10,1286,S2226
8075,THANGA MURUGAN,Desiya Makkal Sakthi Katchi,1030,6,1036,S2226
8076,R. RAJASEKAR,Independent,701,11,712,S2226
8077,R. PRAKASH,Independent,694,6,700,S2226
8078,S. RAJAMOHAN,Independent,659,1,660,S2226
8079,NOTA,None of the Above,7084,208,7292,S2226
8080,CHAVAN VASANTRAO BALWANTRAO,Indian National Congress,526865,2029,528894,S1316
8081,CHIKHALIKAR PRATAPRAO GOVINDRAO,Bharatiya Janata Party,467452,2000,469452,S1316
8082,AVINASH VISHWANATH BHOSIKAR,Vanchit Bahujan  Aaghadi,92090,422,92512,S1316
8083,PANDURANG RAMA ADGULWAR,Bahujan Samaj Party,6879,22,6901,S1316
8084,NIKHIL LAXMANRAO GARJE,Independent,4320,5,4325,S1316
8085,NAGESH SAMBHAJI GAIKWAD,Independent,3316,2,3318,S1316
8086,BHASKAR CHAMPATRAO DOIFODE,Independent,2078,2,2080,S1316
8087,SUSHILA NILKANTHRAO PAWAR,Samnak Janta Party,1873,17,1890,S1316
8088,ABDUL RAIS AHEMAD,Desh Janhit Party,1508,2,1510,S1316
8089,DEVIDAS GOVINDRAO INGLE,Independent,1466,5,1471,S1316
8090,KALPANA SANJAY GAIKWAD,Independent,1305,5,1310,S1316
8091,KAUSAR SULTANA,Indian National League,1211,4,1215,S1316
8092,SAHEBRAO BHIVA GAJBHARE,Independent,1189,4,1193,S1316
8093,JAGDISH LAXMAN POTRE,Independent,960,3,963,S1316
8094,GAJANAN DATTRAMJI DHUMAL,Independent,948,2,950,S1316
8095,LAXMAN NAGORAO PATIL,Independent,921,2,923,S1316
8096,MAHARUDRA KESHAV POPLAITKAR,Independent,911,2,913,S1316
8097,RUKMINBAI SHANKARRAO GITE,Bharatiya Praja Surajya Paksha,897,6,903,S1316
8098,HARI PIRAJI BOYALE,Bahujan Bharat Party,877,1,878,S1316
8099,RATHOD SURESH GOPINATH,Independent,806,2,808,S1316
8100,KADAM SURAJ DEVENDRA,Independent,796,3,799,S1316
8101,RAHUL SURYAKANT YANGADE,Bahujan Mukti Party,734,3,737,S1316
8102,DNYANESHWAR RAOSAHEB KAPATE,Independent,679,2,681,S1316
8103,NOTA,None of the Above,3579,49,3628,S1316
8104,UJJWAL RAMAN SINGH,Indian National Congress,461100,1045,462145,S2452
8105,NEERAJ TRIPATHI,Bharatiya Janata Party,402659,691,403350,S2452
8106,RAMESH KUMAR PATEL,Bahujan Samaj Party,49045,99,49144,S2452
8107,GOPAL SWROOP JOSHI,Independent,4248,0,4248,S2452
8108,AJEET KUMAR PATEL,Pragatisheel Samaj Party,2641,1,2642,S2452
8109,MOOLNIWASI HEMRAJ SINGH,Peoples Party of India (Democratic),2350,5,2355,S2452
8110,GEETA RANI SHARMA,Independent,2197,0,2197,S2452
8111,HANSHRAJ KOL,Apna Dal (Kamerawadi),2137,4,2141,S2452
8112,RAJENDRA PRASAD PRAJAPATI,Bhagidari Party(P),1844,3,1847,S2452
8113,AVANEESH KUMAR,Independent,1834,1,1835,S2452
8114,ANUJ SWAROOP SHUKLA,Independent,1615,1,1616,S2452
8115,SHIV PRASAD VISHWAKARMA,Samyak Party,1326,0,1326,S2452
8116,SARVAJEET SINGH,Kamera Samaj Party,1177,0,1177,S2452
8117,RAJDHAR SINGH PATEL,Rashtriya Samaj Dal (R),1024,1,1025,S2452
8118,NOTA,None of the Above,9949,3,9952,S2452
8119,JUAL ORAM,Bharatiya Janata Party,490655,3627,494282,S182
8120,DILIP KUMAR TIRKEY,Biju Janata Dal,353708,1766,355474,S182
8121,JANARDAN DEHURY,Indian National Congress,260681,1305,261986,S182
8122,JUSTIN LUGUN,Socialist Unity Centre Of India (COMMUNIST),9120,21,9141,S182
8123,JAGABANDHU ORAM,Independent,6023,4,6027,S182
8124,SUMANTA KUMAR SORENG,National Apni Party,4035,17,4052,S182
8125,SANTOSH JURA,Naba Bharata Nirmana Seva Party,3976,5,3981,S182
8126,PARUA EKKA,Jharkhand Party,3018,15,3033,S182
8127,NOTA,None of the Above,17752,49,17801,S182
8128,GIRIDHARI YADAV,Janata Dal  (United),505674,1004,506678,S0427
8129,JAI PRAKASH NARAYAN YADAV,Rashtriya Janata Dal,401567,1267,402834,S0427
8130,NARESH YADAV,Independent,14936,3,14939,S0427
8131,JAY PRAKASH YADAV,Rashtriya Jansambhavna Party,12254,23,12277,S0427
8132,AMRIT TANTI,Bhartiya Dalit Party,9615,55,9670,S0427
8133,NARESH KUMAR PRIYADARSHI,Independent,8103,22,8125,S0427
8134,GANESH KUMAR KUSHAWAHA,Samata Party,7627,18,7645,S0427
8135,UTTAM KUMAR SINGH,Aam Janta Party Rashtriya,6874,37,6911,S0427
8136,KAVINDRA PANDIT,Socialist Unity Centre Of India (COMMUNIST),5226,20,5246,S0427
8137,UMAKANT YADAV,Independent,4932,9,4941,S0427
8138,NOTA,None of the Above,34808,81,34889,S0427
8139,SHOBHANABEN MAHENDRASINH BARAIYA,Bharatiya Janata Party,670929,6389,677318,S065
8140,CHAUDHARI TUSHAR AMARSINH,Indian National Congress,515902,5734,521636,S065
8141,PARMAR RAMESHCHANDRA NANJIBHAI,Bahujan Samaj Party,9850,117,9967,S065
8142,SOLANKI CHHAGANBHAI KEVLABHAI,Independent,7539,12,7551,S065
8143,VIJAYSINH NAVALSINH CHAUHAN,Independent,6692,29,6721,S065
8144,BHAVNABA NARENDRASINH PARMAR,Independent,5365,94,5459,S065
8145,ANILKUMAR NIRANJANKUMAR MUNDADA,Log Party,5225,22,5247,S065
8146,MUSTAKBHAI JAMALBHAI SANGHANI,Independent,3196,7,3203,S065
8147,KATARA VARUNKUMAR KALYANSINH,Gunj Satya Ni Janata Party,2717,56,2773,S065
8148,RAKESHSINH MAHOBATSINH ZALA,Bhartiya Jan Parishad,1882,69,1951,S065
8149,PANDOR KAUSHIKKUMAR SHANKARBHAI,Independent,1782,45,1827,S065
8150,ASHOK L VAGHELA,Independent,1673,15,1688,S065
8151,KANUBHAI KHIMJIBHAI GADHAVI,Independent,1467,38,1505,S065
8152,THAKOR INDIRABEN JITENDRASINH,Insaniyat Party,1402,34,1436,S065
8153,NOTA,None of the Above,20665,411,21076,S065
8154,HEMAMALINI DHARMENDRA DEOL,Bharatiya Janata Party,507535,2529,510064,S2417
8155,MUKESH DHANGAR,Indian National Congress,216043,614,216657,S2417
8156,SURESH SINGH,Bahujan Samaj Party,188152,265,188417,S2417
8157,BHANU PRATAP SINGH,Independent,15640,25,15665,S2417
8158,RAKESH KUMAR,Independent,4492,2,4494,S2417
8159,JAGDISH PRASAD KAUSHIK ADVOCATE,Rashtriya Samta Vikas Party,3567,8,3575,S2417
8160,RAVI VERMA,Independent,2724,0,2724,S2417
8161,SHIKHA SHARMA,Independent,2246,5,2251,S2417
8162,KAMAL KANT SHARMA,Independent,1491,12,1503,S2417
8163,YOGESH KUMAR TALAN,Independent,1491,2,1493,S2417
8164,MONI FALHARI BAPU,Independent,1322,4,1326,S2417
8165,KSHETRA PAL SINGH,Independent,1206,5,1211,S2417
8166,DR. RASHMI YADAV,Independent,1183,6,1189,S2417
8167,PRAVESHANAND PURI,Independent,1081,4,1085,S2417
8168,SURESH CHANDRA VAGHEL,Rashtriya Shoshit Samaj Party,822,7,829,S2417
8169,NOTA,None of the Above,4527,36,4563,S2417
8170,DR BYREDDY SHABARI,Telugu Desam,689417,11714,701131,S0117
8171,POCHA BRAHMANANDA REDDY,Yuvajana Sramika Rythu Congress Party,583155,6001,589156,S0117
8172,J LAKSHMI NARASIMHA YADAV,Indian National Congress,54920,1284,56204,S0117
8173,P GURUVAIAH,Independent,8190,1,8191,S0117
8174,A CHINNA MOULALI,Bahujan Samaj Party,7768,63,7831,S0117
8175,HAFIZ ATAULLAH KHAN,Social Democratic Party Of India,6858,74,6932,S0117
8176,KOMMUSANI PEDDA KAMBAGIRI SWAMY,Independent,4633,0,4633,S0117
8177,GAGGERA VENKATA RAMANAIAH,Independent,3027,4,3031,S0117
8178,DUMAVATH SWAMY NAIK,Independent,2348,10,2358,S0117
8179,KUNUKUNTLA RAMUDU,Independent,1408,5,1413,S0117
8180,E ANIL KUMAR,Independent,1332,2,1334,S0117
8181,C SURENDRA NATHA REDDY,Independent,1267,1,1268,S0117
8182,BRAHMANANDA REDDY K,Independent,1261,11,1272,S0117
8183,UPPU SUBBARAYUDU,Jaathia Chethi Vruthula Ikya Vedika Party,785,6,791,S0117
8184,NAGESWARA RAO,Independent,678,2,680,S0117
8185,VIJAYA BHASKAR REDDYPOGU,Independent,641,0,641,S0117
8186,YELAMPALLE GOVARDHAN REDDY,All India Forward Bloc,638,4,642,S0117
8187,BHUMA VEERA BHADRA REDDY,Navarang Congress Party,630,16,646,S0117
8188,PANDU RANGA YADAV SIDDAPU,Samajwadi Party,594,11,605,S0117
8189,CHANDINI REDDY VAKATI,Liberation Congress Party,546,10,556,S0117
8190,B C RAMANADHA AREDDY,Independent,472,0,472,S0117
8191,GAJULA SHALIMIYA,Anna YSR Congress Party,468,18,486,S0117
8192,KULURU RAMA KRISHNA REDDY,Neethi Nijayithi Party,428,2,430,S0117
8193,CH P MALLESWARUDU,Independent,417,4,421,S0117
8194,I V PAKKIR REDDY,Independent,408,2,410,S0117
8195,V MADHUSUDHANA REDDY,Independent,399,2,401,S0117
8196,BUSHAKU MAHESWARA REDDY,Independent,390,0,390,S0117
8197,U P MUNI REDDY,Independent,376,0,376,S0117
8198,GOGULA SUGUNAMMA,Jai Maha Bharath Party,375,4,379,S0117
8199,BELLAMKONDA SREENIVASULU,Independent,352,1,353,S0117
8200,BALIJA SHIVA KUMAR,Independent,288,0,288,S0117
8201,NOTA,None of the Above,10538,159,10697,S0117
8202,GAJENDRA SINGH PATEL,Bharatiya Janata Party,818291,1572,819863,S1227
8203,PORLAL BATHA KHARTE,Indian National Congress,683651,1194,684845,S1227
8204,DEVISINGH NARGAVE,Communist Party of India,14680,6,14686,S1227
8205,SHOBHARAM DAWAR,Bahujan Samaj Party,12047,22,12069,S1227
8206,NARSINGH SOLANKI,Independent,9052,6,9058,S1227
8207,NOTA,None of the Above,18237,20,18257,S1227
8208,SELVARAJ V,Communist Party of India,462759,2285,465044,S2229
8209,DR SURSITH SANKAR G,All India Anna Dravida Munnetra Kazhagam,254676,1411,256087,S2229
8210,KARTHIKA M,Naam Tamilar Katchi,130846,448,131294,S2229
8211,RAMESHGOVIND S G M,Bharatiya Janata Party,101535,638,102173,S2229
8212,VIJAYARAGAVAN N,Independent,3072,30,3102,S2229
8213,SUBRAMANIAN K,Independent,2434,33,2467,S2229
8214,JAGADEESH J BE,Bahujan Samaj Party,1789,17,1806,S2229
8215,BOOMINATHAN B,Desiya Makkal Sakthi Katchi,1048,2,1050,S2229
8216,PREM S,Independent,1047,23,1070,S2229
8217,NOTA,None of the Above,8843,75,8918,S2229
8218,SAGAR ESHWAR KHANDRE,Indian National Congress,665162,1155,666317,S107
8219,BHAGWANTH KHUBA,Bharatiya Janata Party,535766,1676,537442,S107
8220,AMBADAS SOPANRAO HULSURE,Bahujan Bharat Party,5300,2,5302,S107
8221,PUTARAJ,Bahujan Samaj Party,4541,13,4554,S107
8222,DR. DINKAR MORE,Independent,4105,11,4116,S107
8223,SRI ROPH ABDUL GANI,Independent,3101,3,3104,S107
8224,SHIVRAJ ADIVEPPA SATWAR,Independent,3076,3,3079,S107
8225,RAMVILAS RAMULALJI NAVANDAR,Independent,2694,0,2694,S107
8226,RIYAZ AHMED,Independent,1710,1,1711,S107
8227,MOHD. SHAFEEQ UR RAHAMAN,All India Ulama Congress,1684,10,1694,S107
8228,JAIRAJ KASHAPPA BUKKA ADVOCATE,Independent,1493,0,1493,S107
8229,BALBHEEM UNNE,Independent,1462,8,1470,S107
8230,WASEEMUDDIN,Independent,1169,1,1170,S107
8231,MAHESH GORNALKAR,Republican Party of India (A),974,7,981,S107
8232,DILIP KADWAD,Independent,791,7,798,S107
8233,GOPAL M.P. GARAMPALLI,Independent,765,2,767,S107
8234,RAMESH J CHAVAN,Karnataka Rashtra Samithi,471,1,472,S107
8235,RAMCHANDRA NARAYAN KACHAVE,Kranti Kari Jai Hind Sena,468,4,472,S107
8236,NOTA,None of the Above,4674,12,4686,S107
8237,NITIN JAIRAM GADKARI,Bharatiya Janata Party,652809,2218,655027,S1310
8238,VIKAS THAKRE,Indian National Congress,515941,1483,517424,S1310
8239,YOGIRAJ ALIAS YOGESH PATIRAM LANJEWAR,Bahujan Samaj Party,19164,78,19242,S1310
8240,KIVINSUKA VIRENDRA SURYAVANSHI,Desh Janhit Party,2055,4,2059,S1310
8241,ADARSH RAVISHANKAR THAKUR,Independent,1749,1,1750,S1310
8242,ADV ULHAS SHALIKRAM DUPARE,Independent,1346,2,1348,S1310
8243,FAHIM SHAMIM KHAN,Minorities Democratic Party,1072,1,1073,S1310
8244,SURAJ BALRAM MISHRA,Kunbi Bahujan Sawrajya Party,814,3,817,S1310
8245,TEKRAJ BELKHODE,Independent,803,5,808,S1310
8246,GARUDADRI ANAND KUMAR,Akhil Bhartiya Parivar Party,719,1,720,S1310
8247,DHANU WALTHARE,Independent,690,2,692,S1310
8248,VIJAY MANKAR,Ambedkarite Party of India,606,4,610,S1310
8249,ADV. SANTOSH RAMKRISHNA LANJEWAR,All India Forward Bloc,565,2,567,S1310
8250,VISHESH VASANTA FUTANE,Bahujan Republican  Socialist Party,559,3,562,S1310
8251,GUNWANT HARICHANDRA SOMKUWAR,Bharatheeya Jawan Kisan Party,465,6,471,S1310
8252,SHRIDHAR NARAYAN SALVE,Bhim Sena,447,4,451,S1310
8253,SUNIL WANKHEDE,Rashtra Samarpan Party,320,2,322,S1310
8254,DIPAK LAXMANRAO MASKE,Bahujan Maha Party,267,3,270,S1310
8255,NARAYAN TUKARAM CHOUDHARI,Socialist Unity Centre Of India (COMMUNIST),251,0,251,S1310
8256,SANTOSH TULSHIRAM CHAVHAN,Independent,242,0,242,S1310
8257,SUSHIL PATIL,Independent,236,1,237,S1310
8258,SACHIN RAMKRUSHNARAO WAGHADE,Independent,202,0,202,S1310
8259,PRAFUL MANIKCHAND BHANGE,Independent,201,0,201,S1310
8260,VINAYAK BHAURAO AWCHAT,Independent,190,0,190,S1310
8261,BABITA RAJU AWASTHI,Independent,179,3,182,S1310
8262,SAHIL BALCHAND TURKAR,Independent,129,0,129,S1310
8263,NOTA,None of the Above,5434,40,5474,S1310
8264,ADV K FRANCIS GEORGE,Kerala Congress,358369,6262,364631,S1114
8265,THOMAS CHAZHIKADAN,Kerala Congress  (M),272418,4947,277365,S1114
8266,THUSHAR VELLAPPALLY,Bharath Dharma Jana Sena,163227,1819,165046,S1114
8267,VIJU CHERIAN,Bahujan Samaj Party,7075,148,7223,S1114
8268,P O PETER,Samajwadi Jan Parishad,1581,56,1637,S1114
8269,V P KOCHUMON,Socialist Unity Centre Of India (COMMUNIST),1551,44,1595,S1114
8270,JOSSIN K JOSEPH,Independent,1397,92,1489,S1114
8271,CHANDRABOSE P,Independent,1071,16,1087,S1114
8272,M M SCARIA,Independent,913,14,927,S1114
8273,JOEMON JOSEPH SRAMPICKAL A P J JUMAN V S,Independent,875,18,893,S1114
8274,ROBY MATTAPPALLY,Independent,697,42,739,S1114
8275,SANTHOSH PULICKAL,Independent,686,24,710,S1114
8276,SUNIL ALANCHERIL,Independent,499,28,527,S1114
8277,MAN HOUSE MANMADHAN,Independent,403,18,421,S1114
8278,NOTA,None of the Above,11804,129,11933,S1114
8279,SHREYAS. M. PATEL,Indian National Congress,670274,2714,672988,S1016
8280,PRAJWAL REVANNA,Janata Dal  (Secular),626536,3803,630339,S1016
8281,GANGADHAR BAHUJAN,Bahujan Samaj Party,12068,105,12173,S1016
8282,DEVARAJ M.Y,Karnataka Rashtra Samithi,6033,24,6057,S1016
8283,H D REVANNA,Purvanchal Mahapanchayat,4256,16,4272,S1016
8284,BASAVARAJU J.D (EX-ARMY),Independent,3983,80,4063,S1016
8285,SANTHOSH B.N,Independent,3444,5,3449,S1016
8286,HEMANTH GAVEESH,Independent,3277,4,3281,S1016
8287,PRATHAPA K.A,Uttama Prajaakeeya Party,3213,37,3250,S1016
8288,S.K. NINGARAJA,Bahujan Bharat Party,1710,20,1730,S1016
8289,B.N. SURESHA (SURESHGOWDA),Independent,1409,9,1418,S1016
8290,SIDDABHOVI,Independent,940,47,987,S1016
8291,SHIVARAJ. B,Republican Party of India Bharatha,843,5,848,S1016
8292,R.G. SATHISHA RAMEDEVARAPURA,Independent,823,46,869,S1016
8293,K.R. GANGADHARAPPA,Independent,734,8,742,S1016
8294,NOTA,None of the Above,8470,71,8541,S1016
8295,PIYUSH GOYAL,Bharatiya Janata Party,678451,1695,680146,S1326
8296,BHUSHAN PATIL,Indian National Congress,321455,1083,322538,S1326
8297,ADV. SONAL DIWAKAR GONDANE,Vanchit Bahujan  Aaghadi,6007,45,6052,S1326
8298,RAIS DOCTOR,Bahujan Samaj Party,2907,16,2923,S1326
8299,PANDEY DHARMENDRA RAMMURAT,Independent,1481,0,1481,S1326
8300,DIPTI ASHOK WALAWALKAR,Independent,1461,11,1472,S1326
8301,COMRADE JAYRAM VISHWAKARMA,Socialist Unity Centre Of India (COMMUNIST),1194,1,1195,S1326
8302,MUNNALAL GAJRAJ PRAJAPATI,Independent,968,3,971,S1326
8303,LAXMAN YELLPPA KURADE,Independent,680,6,686,S1326
8304,ADVOCATE KAPIL K. SONI,Independent,630,3,633,S1326
8305,DEEPALI BHAWARSING SHEKHAWAT,Maharashtra Vikas Aghadi,621,4,625,S1326
8306,KAMLESH DAYABHAI VYAS,Sardar Vallabhbhai Patel Party,619,3,622,S1326
8307,BIPIN BACHUBHAI SHAH,Hindu Samaj Party,505,3,508,S1326
8308,GURUDAS RAMDAS KHAIRNAR,Independent,484,2,486,S1326
8309,RAVI BABU GAVLI,Samata Party,447,3,450,S1326
8310,JAEENDRA VASANT SURVE,Bharatheeya Jawan Kisan Party,398,7,405,S1326
8311,ALIEK SUNDER MESHRAM,Bharatiya Mulnivasi Aazad Party,393,3,396,S1326
8312,SAYED ZULFIQAR ALAM,Bahujan Maha Party,344,4,348,S1326
8313,SANJAY MAFATLAL MORAKHIA,Independent,210,0,210,S1326
8314,NOTA,None of the Above,13248,98,13346,S1326
8315,SARBANANDA SONOWAL,Bharatiya Janata Party,691153,2609,693762,S0313
8316,LURINJYOTI GOGOI,Assam Jatiya Parishad,412793,1648,414441,S0313
8317,MANOJ DHANOWAR,Aam Aadmi Party,137618,246,137864,S0313
8318,NOTA,None of the Above,32163,92,32255,S0313
8319,RUCHI VIRA,Samajwadi Party,636733,630,637363,S246
8320,KUNWAR SARVESH KUMAR,Bharatiya Janata Party,530176,1425,531601,S246
8321,MO IRFAN,Bahujan Samaj Party,92116,197,92313,S246
8322,AJAY YADAV,Apna Haq Party,4084,10,4094,S246
8323,MUSHARRAT HUSAIN,Independent,2583,0,2583,S246
8324,SADHNA SINGH,Independent,2292,4,2296,S246
8325,MOHD JAMSHED,Independent,1717,2,1719,S246
8326,ONKAR SINGH,Bharatiya Bahujan Samta Party,1449,10,1459,S246
8327,SHAKIL AHMED,Samata Party,1356,0,1356,S246
8328,HAR KISHORE SINGH,Socialist Unity Centre Of India (COMMUNIST),940,0,940,S246
8329,AMARJEET SINGH JATAV,Independent,937,15,952,S246
8330,GANGARAM SHARMA,Rashtriya Congress(J) Party,629,56,685,S246
8331,NOTA,None of the Above,5807,17,5824,S246
8332,AMOL GAJANAN KIRTIKAR,Shiv Sena (Uddhav Balasaheb Thackrey),451095,1501,452596,S1327
8333,RAVINDRA DATTARAM WAIKAR,Shiv Sena,451094,1550,452644,S1327
8334,PARMESHWAR ASHOK RANSHUR,Vanchit Bahujan  Aaghadi,10001,51,10052,S1327
8335,RAJESH RAMKISAN MALLAH,Bahujan Samaj Party,4790,22,4812,S1327
8336,SAMEER MORE,Independent,3171,2,3173,S1327
8337,SUNIL BHIMA CHAVAN,Independent,1999,3,2002,S1327
8338,BALA VENKATESH VINAYAK NADAR,Aapki Apni Party (Peoples),1756,7,1763,S1327
8339,ARORA SURINDER MOHAN,Bharat Jan Aadhar Party,1667,8,1675,S1327
8340,ROHAN SATONE,Independent,1476,3,1479,S1327
8341,ADV. SANJEEVKUMAR APPARAV KALKORI,Independent,1184,13,1197,S1327
8342,ADV. LATA PANDURANG SHINDE,Independent,1152,2,1154,S1327
8343,MANOJ SHRAVAN NAYAK,Right to Recall Party,1132,17,1149,S1327
8344,HRUDA DHANANJAY SHINDE,Independent,1066,12,1078,S1327
8345,BHARAT KHIMJI SHAH,Hindu Samaj Party,932,5,937,S1327
8346,SUSHMA DAYANAND MEHTA,Independent,875,7,882,S1327
8347,ADVOCATE KAPIL KANTILAL SONI,Independent,776,4,780,S1327
8348,SARIKA DABRAL,India Greens Party,760,8,768,S1327
8349,GAJANAN TUKARAM SONKAMBLE,Independent,496,5,501,S1327
8350,ADV MITESH VARSHNEY,Bhim Sena,492,5,497,S1327
8351,HARISHANKAR YADAV,Samaj Vikas Kranti Party,398,7,405,S1327
8352,SANTOSH MANIK RAYBAN,Independent,234,0,234,S1327
8353,NOTA,None of the Above,15036,125,15161,S1327
8354,MALVIKA DEVI,Bharatiya Janata Party,538535,5768,544303,S1811
8355,LAMBODAR NIAL,Biju Janata Dal,408267,2223,410490,S1811
8356,DROUPADI MAJHI,Indian National Congress,300060,3139,303199,S1811
8357,UMAKANTA TANDI,Independent,9180,14,9194,S1811
8358,BIRANCHI NARAYAN DURGA,Bahujan Samaj Party,8440,57,8497,S1811
8359,DR. DHARMANANDA GAHIR,Independent,7775,36,7811,S1811
8360,SIBA HATI,Samajwadi Party,7138,30,7168,S1811
8361,RAJARAM SAHU,Independent,6712,18,6730,S1811
8362,NARESH HIANLA,Independent,6627,14,6641,S1811
8363,GANGADHAR JAL,Independent,5547,43,5590,S1811
8364,HIMANSHU TRIPATHY,Samruddha Odisha,4898,8,4906,S1811
8365,NOTA,None of the Above,19620,95,19715,S1811
8366,KRISHNA PRASAD TENNETI,Telugu Desam,706757,10736,717493,S0115
8367,NANDIGAM SURESH BABU,Yuvajana Sramika Rythu Congress Party,503816,5646,509462,S0115
8368,J.D. SEELAM,Indian National Congress,41673,1586,43259,S0115
8369,DOKKA JAGAN MOHANA RAO,Bahujan Samaj Party,6774,83,6857,S0115
8370,NALAMALA TIRUPATI RAO,Navataram Party,2888,76,2964,S0115
8371,BUSSA. NAGARAJU,Independent,1311,7,1318,S0115
8372,GADDE. VIJAYA LAKSHMI,Independent,1046,5,1051,S0115
8373,KATTAPOGU. VIJAY KUMAR,Pyramid Party of India,893,4,897,S0115
8374,KONDRU KIRAN KUMAR,Independent,791,6,797,S0115
8375,KATTA ANAND BABU,Independent,704,25,729,S0115
8376,MERUGUPALA SADASIVA RAO,India Praja Bandhu Party,669,4,673,S0115
8377,KATTA HEMANAND,Independent,547,2,549,S0115
8378,PARRE. KOTAIAH,Jaibhim Rao Bharat Party,408,4,412,S0115
8379,PALADUG VIJENDRA RAO (BAHUJAN),Liberation Congress Party,294,12,306,S0115
8380,CHINNAM MURALIDHAR,All Peoples Party,252,3,255,S0115
8381,NOTA,None of the Above,13599,124,13723,S0115
8382,HIBI EDEN,Indian National Congress,478989,3328,482317,S1112
8383,K. J. SHINE TEACHER,Communist Party of India  (Marxist),230059,1873,231932,S1112
8384,DR. K. S. RADHAKRISHNAN,Bharatiya Janata Party,143573,927,144500,S1112
8385,ADV. ANTONY JUDY,Twenty 20 Party,39658,150,39808,S1112
8386,VAYALAR JAYAKUMAR,Bahujan Samaj Party,1480,18,1498,S1112
8387,SANDEEP RAJENDRAPRASAD,Independent,734,18,752,S1112
8388,CYRILL SKARIA,Independent,663,27,690,S1112
8389,PRATHAPAN,Bahujan Dravida Party,414,5,419,S1112
8390,BRAHMAKUMAR,Socialist Unity Centre Of India (COMMUNIST),409,3,412,S1112
8391,ROHIT KRISHNAN,Independent,408,8,416,S1112
8392,NOTA,None of the Above,7715,43,7758,S1112
8393,OM BIRLA,Bharatiya Janata Party,744396,6100,750496,S2024
8394,PRAHLAD GUNJAL,Indian National Congress,702623,5899,708522,S2024
8395,DHANRAJ YADAV,Bahujan Samaj Party,7547,28,7575,S2024
8396,ASHISH YOGI,Ekam Sanatan Bharat Dal,5756,19,5775,S2024
8397,LAKSHMICHAND,Independent,3890,2,3892,S2024
8398,SATYENDRA KUMAR JAIN,Independent,2520,1,2521,S2024
8399,RAMNATH MEHRA,Independent,2407,15,2422,S2024
8400,MOINUDDIN,Independent,1854,6,1860,S2024
8401,BHANWAR KUMAR RAWAL,Independent,1102,29,1131,S2024
8402,BALDEV SINGH FOJI,Bharatheeya Jawan Kisan Party,1066,3,1069,S2024
8403,TARUN GOCHAR,Right to Recall Party,992,8,1000,S2024
8404,KAILASHI ANIL JAIN,Independent,990,4,994,S2024
8405,KAMAL KUMAR BAIRWA,Independent,965,49,1014,S2024
8406,ABDUL ASIF,Independent,860,5,865,S2024
8407,OM PRAKASH SHAKYAWAL,Independent,757,3,760,S2024
8408,NOTA,None of the Above,10176,85,10261,S2024
8409,RAM SHIROMANI VERMA,Samajwadi Party,510754,301,511055,S2458
8410,SAKET MISRA,Bharatiya Janata Party,434192,190,434382,S2458
8411,MUINUDDIN AHAMAD KHAN URF HAZI DADDAN KHAN,Bahujan Samaj Party,56225,26,56251,S2458
8412,AHMAD JIYA KHAN,Peace Party,15630,0,15630,S2458
8413,SHANTI DEVI,Independent,4010,1,4011,S2458
8414,SUJEET KUMAR,Independent,3946,0,3946,S2458
8415,YUGAL KISHOR SHUKLA,Aam Janta Party (India),2672,1,2673,S2458
8416,KRISHNA KUMAR MAURYA,Samyak Party,2266,1,2267,S2458
8417,MALIK RAM,Independent,2111,2,2113,S2458
8418,ANIL KUMAR TIWARI,Independent,1513,1,1514,S2458
8419,HANUMAN PRASAD MISHRA,Kisan Mazdoor Sangharsh Party,1494,1,1495,S2458
8420,KUMARI GEETA GAUTAM,Rashtriya Janta Party,1317,2,1319,S2458
8421,NOTA,None of the Above,9872,0,9872,S2458
8422,AKHILESH YADAV,Samajwadi Party,640207,2085,642292,S2442
8423,SUBRAT PATHAK,Bharatiya Janata Party,470131,1239,471370,S2442
8424,IMRAN BIN ZAFAR,Bahujan Samaj Party,81471,168,81639,S2442
8425,ALOK VERMA,Rashtriya Shoshit Samaj Party,4484,8,4492,S2442
8426,LALIT KUMARI,Independent,3262,5,3267,S2442
8427,SINOD KUMAR,Independent,1732,1,1733,S2442
8428,RAJ KATHERIA,Independent,1463,1,1464,S2442
8429,BHANU PRATAP SINGH DOHRE,Independent,1430,2,1432,S2442
8430,SHAILENDRA KUMAR,Bharatiya Kisan Parivartan Party,1141,10,1151,S2442
8431,YADVENDRA KISHOR,Independent,1061,1,1062,S2442
8432,SUBHASH CHANDRA,All India Forward Bloc,799,2,801,S2442
8433,SUNIL,Bhartiya Shakti Chetna Party,738,1,739,S2442
8434,PRAMOD KUMAR YADAV,Bhartiya Krishak Dal,557,3,560,S2442
8435,PURUSHOTTAM TIWARI,Independent,541,2,543,S2442
8436,IRFAN ALI,Independent,463,7,470,S2442
8437,NOTA,None of the Above,4805,13,4818,S2442
8438,PARTHA BHOWMICK,All India Trinamool Congress,518486,1745,520231,S2515
8439,ARJUN SINGH,Bharatiya Janata Party,454184,1609,455793,S2515
8440,DEBDUT GHOSH,Communist Party of India  (Marxist),109038,526,109564,S2515
8441,MD JAMIR HOSSAIN,All India Secular Front,18797,9,18806,S2515
8442,ROHIT KUMAR PATHAK,Independent,7116,16,7132,S2515
8443,CHAPALA RAY (MAJUMDER),Bahujan Samaj Party,3882,27,3909,S2515
8444,SHARMISTHA DAS,Independent,3622,12,3634,S2515
8445,ANJAN GOSWAMI,Bharatiya Nyay-Adhikar Raksha Party,3434,14,3448,S2515
8446,DHARMENDRA SINGH,Independent,2843,4,2847,S2515
8447,SANJAY SINGH,Independent,1670,6,1676,S2515
8448,DEBASISH BANERJEE,Socialist Unity Centre Of India (COMMUNIST),1422,12,1434,S2515
8449,KUNDAN SINGH,Independent,820,6,826,S2515
8450,UDAY VEER CHOUDHURY,Independent,745,12,757,S2515
8451,AMIT KUMAR CHOUBEY,Independent,717,4,721,S2515
8452,NOTA,None of the Above,11043,39,11082,S2515
8453,RAVI SHANKAR PRASAD,Bharatiya Janata Party,587212,1058,588270,S0430
8454,ANSHUL AVIJIT,Indian National Congress,433818,606,434424,S0430
8455,RAKESH SHARMA,Independent,9942,1,9943,S0430
8456,NEERAJ KUMAR,Bahujan Samaj Party,5912,16,5928,S0430
8457,AWADHESH PRASAD,Independent,4973,1,4974,S0430
8458,ENG UMESH RAJAK,Peoples Party of India (Democratic),4664,8,4672,S0430
8459,SANJAY KUMAR URF SANJAY BALMIKI,Independent,4643,0,4643,S0430
8460,DHARMVIR KUMAR BHASKAR,Independent,2415,1,2416,S0430
8461,AMIT KUMAR ALBELA,Independent,2050,3,2053,S0430
8462,MAHESH KUMAR,Samata Party,2003,0,2003,S0430
8463,DHANJAY KUMAR,Rashtriya Jansambhavna Party,1969,2,1971,S0430
8464,GULAB PRASAD,Loktantrik Samajwadi Party,1923,2,1925,S0430
8465,SUMIT RANJAN SINHA,Akhand Bharat Janpriya Party,1715,1,1716,S0430
8466,MAHBOOB ALAM ANSARI,Bharatiya Momin Front,1635,3,1638,S0430
8467,DR RAKESH DUTTA MISHRA,Bharatiya Jan Kranti Dal (Democratic),1238,2,1240,S0430
8468,SAROJ KUMAR SUMAN,Socialist Unity Centre Of India (COMMUNIST),1078,0,1078,S0430
8469,SHAHID ALAM,Jantantra Awaj Party,1040,3,1043,S0430
8470,NOTA,None of the Above,5532,27,5559,S0430
8471,RAJPALSINH MAHENDRASINH JADAV,Bharatiya Janata Party,785830,8749,794579,S0618
8472,GULABSINH SOMSINH CHAUHAN,Indian National Congress,279396,5841,285237,S0618
8473,HASMUKHKUMAR GANPATSINH RATHOD,Independent,10376,23,10399,S0618
8474,JITESHKUMAR GHANSHYAMBHAI SEVAK,Dhanwan Bharat Party,8350,39,8389,S0618
8475,MANOJSINH RANAJITSINH RATHOD,Independent,3984,29,4013,S0618
8476,LAXMANBHAI GALABHAI BARIYA,"Aam Janmat Party,",3108,97,3205,S0618
8477,TASLIM MOHAMMEDRAFIK DURVESH,Independent,3051,14,3065,S0618
8478,PANDOR KAUSHIKKUMAR SHANKARBHAI,Independent,2486,21,2507,S0618
8479,NOTA,None of the Above,19629,474,20103,S0618
8480,DR. HEMANT VISHNU SAVARA,Bharatiya Janata Party,600208,1036,601244,S1322
8481,BHARTI BHARAT KAMDI,Shiv Sena (Uddhav Balasaheb Thackrey),416822,1116,417938,S1322
8482,RAJESH RAGHUNATH PATIL,Bahujan Vikas Aaghadi,254011,506,254517,S1322
8483,BHARAT SAMJI VANGA,Bahujan Samaj Party,15425,40,15465,S1322
8484,MEENA KISHOR BHAD,Independent,14223,12,14235,S1322
8485,VIJAYA RAJKUMAR MHATRE,Vanchit Bahujan  Aaghadi,10882,54,10936,S1322
8486,MOHAN BARAKU GUHE,Bharat Adivasi Party,10737,24,10761,S1322
8487,DINKAR DATTATRAYA WADHAN,Independent,10672,15,10687,S1322
8488,AMAR KISAN KAVALE,Independent,9806,15,9821,S1322
8489,COMRADE RAHUL MEDHA,Marxist Leninist Party of India (Red Flag),7061,24,7085,S1322
8490,NOTA,None of the Above,23312,73,23385,S1322
8491,VISHWESHWAR HEGDE KAGERI,Bharatiya Janata Party,777887,4608,782495,S1012
8492,DR. ANJALI NIMBALKAR,Indian National Congress,443296,1771,445067,S1012
8493,RAJSHEKHAR. SHANKAR. HINDALAGI.,Independent,5384,13,5397,S1012
8494,GANAPATI HEGDE,Socialist Unity Centre Of India (COMMUNIST),4427,45,4472,S1012
8495,NIRANJAN UDAYSINH SIRDESAI,Independent,4116,53,4169,S1012
8496,NAGARAJ. ANANT. SHIRALI.,Independent,2860,22,2882,S1012
8497,CHIDANAND  HANUMANTHAPPA HARIJAN,Independent,1707,14,1721,S1012
8498,PRAJAAKEEYA SUNIL,Uttama Prajaakeeya Party,1523,43,1566,S1012
8499,VINAYAK NAIK,Karnataka Rashtra Samithi,1230,33,1263,S1012
8500,K. P. PATIL,Independent,901,55,956,S1012
8501,KRISHNA BALEGAR,Independent,897,23,920,S1012
8502,ARAVIND GOWDA,Independent,872,32,904,S1012
8503,AVINASH. NARAYAN. PATIL.,Independent,761,12,773,S1012
8504,NOTA,None of the Above,10151,25,10176,S1012
8505,TARIQ ANWAR,Indian National Congress,565025,2067,567092,S0411
8506,DULAL CHANDRA GOSWAMI,Janata Dal  (United),516199,1030,517229,S0411
8507,GOPAL KUMAR MAHTO,Bahujan Samaj Party,14452,46,14498,S0411
8508,GYANESHWAR SOREN,Independent,12307,10,12317,S0411
8509,KHALID MOBARAK,Independent,10828,43,10871,S0411
8510,RAJ KUMAR MANDAL,Rashtriya Jansambhavna Party,8473,14,8487,S0411
8511,VISHNU SINGH,Bharat Jago Janta Party,6303,37,6340,S0411
8512,MARANG HANSADA,Peoples Party of India (Democratic),5875,14,5889,S0411
8513,BINDU KUMARI,Samaj Shakti Party,5866,18,5884,S0411
8514,NOTA,None of the Above,22866,73,22939,S0411
8515,GYANESHWAR PATIL,Bharatiya Janata Party,861188,1491,862679,S1228
8516,NARENDRA PATEL,Indian National Congress,591540,1168,592708,S1228
8517,MUNNALAL S/O DHANNALAL TEJI,Bahujan Samaj Party,11796,22,11818,S1228
8518,ABHINESH SINGH,Rashtriya Jan Awaz Party,9295,4,9299,S1228
8519,LAXMI NARAYAN KATARE,Independent,4902,3,4905,S1228
8520,MANOJ KUMAR VISHWAMBHARNATH AGRAWAL,Independent,4346,1,4347,S1228
8521,MAHESH PAWAR,Peoples Party of India (Democratic),3701,8,3709,S1228
8522,SHIVAM SEN,Independent,3479,2,3481,S1228
8523,RAVINDRA SONVANE,Independent,2679,6,2685,S1228
8524,PRAKASH RATHOR BANJARA,Aam Janta Party (India),2368,2,2370,S1228
8525,NARAYAN SUKHADEV PAL,Bharatiya Yuva Jan Ekta Party,1699,3,1702,S1228
8526,NOTA,None of the Above,12817,22,12839,S1228
8527,BASAVARAJ BOMMAI,Bharatiya Janata Party,702189,3349,705538,S1010
8528,ANANDSWAMY GADDADEVARMATH,Indian National Congress,660191,1834,662025,S1010
8529,SUNANDA KARIYAPPA SHIRHATTI,Independent,4705,2,4707,S1010
8530,KHAJAMOHIDDIN GUDAGERI,Socialist Party (India),3398,3,3401,S1010
8531,GANGADHAR BADIGER,Socialist Unity Centre Of India (COMMUNIST),2264,6,2270,S1010
8532,RUDRAPPA BASAPPA KUMBAR,Independent,1352,4,1356,S1010
8533,BASAVARAJ B HADI,Independent,1065,6,1071,S1010
8534,PRAJAKEEYA SACHINKUMAR KARJEKANNAVAR,Uttama Prajaakeeya Party,1058,14,1072,S1010
8535,DR. G H IMRAPUR,Independent,930,23,953,S1010
8536,JAGADISH YALLAPPA BANKAPURA,Independent,660,14,674,S1010
8537,TANU CHIKKANNA YADAV,Karnataka Rashtra Samithi,628,8,636,S1010
8538,H K NARASIMHAPPA,Samajwadi Janata Party(Karnataka),445,1,446,S1010
8539,VISHWANATH SHEERI,Ekam Sanatan Bharat Dal,401,0,401,S1010
8540,RASHEEDA BEGUM,Indian Movement Party,396,1,397,S1010
8541,NOTA,None of the Above,10831,34,10865,S1010
8542,PRAVEEN KHANDELWAL,Bharatiya Janata Party,514958,1538,516496,U051
8543,JAI PRAKASH AGARWAL,Indian National Congress,426542,629,427171,U051
8544,ABUL KALAM AZAD,Bahujan Samaj Party,5820,9,5829,U051
8545,UMESH RATHOR,Atulya Bharat Party,1614,3,1617,U051
8546,SEEMA RIZVI,Azad Samaj Party,1089,0,1089,U051
8547,SHAIK JALEEL,Navarang Congress Party,947,2,949,U051
8548,MD NAZIR,Aman Samaj Party,945,0,945,U051
8549,SATYA DEV CHAUDHARY,Satya Bahumat Party,842,0,842,U051
8550,RITU KAUSHIK,Socialist Unity Centre Of India (COMMUNIST),642,1,643,U051
8551,SAMEER MIRZA,Rashtriya Republican Party,513,0,513,U051
8552,SOHARSH GULGULIA JAIN,Swaraj Bhartiya Nyay Party,503,0,503,U051
8553,SHYAM BHARTEEY,Gareeb Aadmi Party,462,1,463,U051
8554,GULJAR SINGH,Peoples Party of India (Democratic),424,0,424,U051
8555,YOGENDER SINGH,Bharatiya Liberal Party,389,0,389,U051
8556,VINOD KUMAR GUPTA,Akhil Bhartiya Parivar Party,357,2,359,U051
8557,SHIVAM SAINI,Right to Recall Party,330,0,330,U051
8558,MANOJ KUMAR NIGAM,Akhil Bhartiya Sudhar Party,321,0,321,U051
8559,RAJESH GUPTA,Bharat Lok Sewak Party,261,1,262,U051
8560,RAHUL SHARMA,Rashtriya Mangalam Party,256,1,257,U051
8561,SUNIL KUMAR,Independent,247,0,247,U051
8562,SUBHASH CHANDER,Independent,220,0,220,U051
8563,MOHD HAMID,Bharatheeya Jawan Kisan Party,189,0,189,U051
8564,PYUSH NARULA,Independent,172,0,172,U051
8565,HEENA,Public Political Party,169,0,169,U051
8566,ASHOK KUMAR GUPTA,Independent,139,1,140,U051
8567,NOTA,None of the Above,5544,19,5563,U051
8568,SOUGATA RAY,All India Trinamool Congress,526289,2290,528579,S2516
8569,SILBHADRA DATTA,Bharatiya Janata Party,456138,1781,457919,S2516
8570,SUJAN CHAKRABORTY,Communist Party of India  (Marxist),239418,1366,240784,S2516
8571,SHEKH IMANUR RAHMAN,Independent,6410,1,6411,S2516
8572,SWAMINATH KORI,Bahujan Samaj Party,3749,17,3766,S2516
8573,HIRAK SINHA,Independent,3144,3,3147,S2516
8574,BANAMALI PANDA,Socialist Unity Centre Of India (COMMUNIST),1728,11,1739,S2516
8575,DULU DEY,Independent,1688,6,1694,S2516
8576,MANIKA MUKHERJEE,Bharatiya Nyay-Adhikar Raksha Party,1231,6,1237,S2516
8577,SANTANU MANDAL,Democratic Socialist Party of India,880,5,885,S2516
8578,TRIDIB BHUNIA,Independent,765,7,772,S2516
8579,GOURI BISWAS,Independent,698,3,701,S2516
8580,SUBRATA BHOWMIK,Mera Bharat Mahan Party,602,2,604,S2516
8581,HARI PADA BISWAS,Mulnibasi Party of India,465,9,474,S2516
8582,NOTA,None of the Above,11256,78,11334,S2516
8583,BHARATBHAI MANUBHAI SUTARIYA,Bharatiya Janata Party,577820,3052,580872,S0614
8584,JENNY THUMMAR,Indian National Congress,258231,1573,259804,S0614
8585,CHAUHAN RAVAJIBHAI MULABHAI,Bahujan Samaj Party,7486,57,7543,S0614
8586,SANKHAT VIKRAMBHAI VISABHAI,Global Republican Party,4958,51,5009,S0614
8587,BAVKUBHAI AMARUBHAI VALA,Independent,3733,44,3777,S0614
8588,BHAVESHBHAI JENTIBHAI RANK,Independent,3663,8,3671,S0614
8589,PUNJABHAI BAVBHAI DAFDA,Independent,2598,23,2621,S0614
8590,PRITESH CHAUHAN (LALU),Independent,1759,21,1780,S0614
8591,NOTA,None of the Above,11125,224,11349,S0614
8592,DR.SANJAY JAISWAL,Bharatiya Janata Party,578959,1462,580421,S042
8593,MADAN MOHAN TIWARI,Indian National Congress,441363,2490,443853,S042
8594,SANJAY KUMAR,Viro Ke Vir Indian Party,13139,6,13145,S042
8595,UPENDRA RAM,Bahujan Samaj Party,10913,49,10962,S042
8596,MOHAMMAD SOAIB,Independent,8992,2,8994,S042
8597,RAUSHAN KUMAR SRIVASTAVA,Independent,8496,9,8505,S042
8598,MD. KALAM SAI,Independent,4922,3,4925,S042
8599,NAFISH AHMAD,Independent,4163,0,4163,S042
8600,NOTA,None of the Above,11223,65,11288,S042
8601,RAJ BHUSHAN CHOUDHARY,Bharatiya Janata Party,618569,1180,619749,S0415
8602,AJAY NISHAD,Indian National Congress,383759,1063,384822,S0415
8603,ALOK KUMAR SINH,Independent,17225,0,17225,S0415
8604,AWADHESH PRASAD SINGH,Independent,15617,1,15618,S0415
8605,JITENDRA KUMAR,Independent,8692,8,8700,S0415
8606,NILIMA KUMARI,Independent,7309,1,7310,S0415
8607,VIJAYESH KUMAR,Bahujan Samaj Party,6530,17,6547,S0415
8608,AJAY SAHNI,Independent,5157,1,5158,S0415
8609,SUNITA KUMARI,Bajjikanchal Vikas Party,4791,1,4792,S0415
8610,MOHAMMAD ANZARUL HASAN,All India Majlis-E-Ittehadul Muslimeen,4121,10,4131,S0415
8611,MD HAIDAR,Independent,3897,0,3897,S0415
8612,MUKESH KUMAR,Independent,3225,0,3225,S0415
8613,SUDHIR KUMAR OJHA,Bhartiya Sarthak Party,2890,3,2893,S0415
8614,SABINA KHATOON,Indian National League,2445,8,2453,S0415
8615,SANDIP KUMAR,Jantantra Awaj Party,1968,3,1971,S0415
8616,ARVIND KUMAR CHAUDHARY,Socialist Unity Centre Of India (COMMUNIST),1852,5,1857,S0415
8617,AJITANSH GAUR,The Agrani Party,1840,3,1843,S0415
8618,SANJAY KUMAR,Independent,1811,1,1812,S0415
8619,BASKIT KUMAR SHARMA,Independent,1778,1,1779,S0415
8620,SONELAL PASWAN,Independent,1730,1,1731,S0415
8621,MANORANJAN KUMAR,Independent,1595,3,1598,S0415
8622,NAND KISHORE SHARMA,Apna Kisan Party,1521,1,1522,S0415
8623,ABHAY KUMAR,Samata Party,1170,4,1174,S0415
8624,PRABHAKAR RANJAN,Ekam Sanatan Bharat Dal,1115,1,1116,S0415
8625,RAJU SINGH,Independent,984,0,984,S0415
8626,SAROJ KUMAR CHAUDHARY,Independent,965,0,965,S0415
8627,NOTA,None of the Above,7539,49,7588,S0415
8628,VARUN CHAUDHRY,Indian National Congress,662592,1065,663657,S071
8629,BANTO KATARIA,Bharatiya Janata Party,613786,835,614621,S071
8630,PAWAN RANDHAWA,Bahujan Samaj Party,23535,48,23583,S071
8631,GURPREET SINGH,Indian National Lok Dal,8902,84,8986,S071
8632,KAMAL KUMAR BARARA,Aazad Samaj Party (Kanshi Ram),8741,13,8754,S071
8633,KIRAN PUNIA,Jannayak Janta Party,6055,37,6092,S071
8634,RAKESH KUMAR,Haryana Jansena Party,3110,1,3111,S071
8635,BALJEET SINGH,Bharatheeya Jawan Kisan Party,2459,43,2502,S071
8636,MEHAR SINGH CHALIA,Ekam Sanatan Bharat Dal,2383,14,2397,S071
8637,GULAB SINGH NARWAL,Peoples Party of India (Democratic),1683,7,1690,S071
8638,SURAJ KUMAR,Bahujan Mukti Party,1501,5,1506,S071
8639,MOHAR SINGH STATION MASTER (RETD.),Independent,1257,6,1263,S071
8640,BETA MAM CHAND RATTUWALA,Bharatiya Yuva Jan Ekta Party,1248,3,1251,S071
8641,DR. NITESH CHOPRA (HONEY),Bhartiya Shakti Chetna Party,854,3,857,S071
8642,NOTA,None of the Above,6427,25,6452,S071
8643,MANOJ TIGGA,Bharatiya Janata Party,691533,3781,695314,S252
8644,PRAKASH CHIK BARAIK,All India Trinamool Congress,617486,2381,619867,S252
8645,MILI ORAON,Revolutionary Socialist Party,39424,285,39709,S252
8646,PARIMAL ORAON,Independent,12560,24,12584,S252
8647,ARJUN INDWAR,Independent,11090,32,11122,S252
8648,MUNIB NARJINARY,Bahujan Samaj Party,6600,48,6648,S252
8649,RAHUL MARAK,Kisan Mazdoor Sangharsh Party,5679,16,5695,S252
8650,CHANDAN ORAON,Socialist Unity Centre Of India (COMMUNIST),2751,36,2787,S252
8651,BINAY MURMU,North Bengal People’s Party,2700,58,2758,S252
8652,NRIPENDRA NARAYAN DEBKARJEE,Kamatapur People’s Party (United),2017,38,2055,S252
8653,BABITA BARA,Gana Suraksha Party,1522,30,1552,S252
8654,NOTA,None of the Above,21235,63,21298,S252
8655,DR. M.P ABDUSSAMAD SAMADANI,Indian Union Muslim League,559570,2946,562516,S117
8656,K.S HAMZA,Communist Party of India  (Marxist),324562,2194,326756,S117
8657,ADV. NIVEDIDA,Bharatiya Janata Party,123733,1065,124798,S117
8658,ABDUSSAMED MALAYAMPALLI,Independent,1634,19,1653,S117
8659,VINOD,Bahujan Samaj Party,1449,28,1477,S117
8660,HAMSA S/O MOIDUTTY,Independent,952,26,978,S117
8661,BINDHU W/O DEVARAJAN,Independent,826,21,847,S117
8662,HAMZA KADAVANDI,Independent,707,3,710,S117
8663,NOTA,None of the Above,6499,62,6561,S117
8664,MANJU SHARMA,Bharatiya Janata Party,878643,8207,886850,S207
8665,PRATAP SINGH KHACHARIYAWAS,Indian National Congress,549424,5659,555083,S207
8666,RAJESH TANWAR,Bahujan Samaj Party,3420,41,3461,S207
8667,HARI NARAYAN MEENA,Independent,2193,9,2202,S207
8668,RAJEEV ROLIWAL,Independent,962,8,970,S207
8669,YOGESH SHARMA,Independent,811,5,816,S207
8670,NARENDER SHARMA,Rashtriya Sanatan Party,665,4,669,S207
8671,KULDEEP SINGH,Socialist Unity Centre Of India (COMMUNIST),605,10,615,S207
8672,DR. ASEEM VERMA,Independent,562,10,572,S207
8673,PRADEEP VERMA,Indian Peoples Green Party,445,3,448,S207
8674,ADVOCATE HARI KISHAN TIWARI,Bheem Tribal Congress,384,16,400,S207
8675,SHASHANK SINGH ARYA,Right to Recall Party,372,21,393,S207
8676,TRILOK TIWARI,Rashtriya Samta Vikas Party,344,7,351,S207
8677,NOTA,None of the Above,10280,148,10428,S207
8678,ANANTA NAYAK,Bharatiya Janata Party,571133,2790,573923,S184
8679,DHANURJAYA SIDU,Biju Janata Dal,476206,675,476881,S184
8680,BINOD BIHARI NAIK,Indian National Congress,104944,334,105278,S184
8681,JOHN MIRAN MUNDA,Independent,31729,7,31736,S184
8682,SAHEBA JUANGA,Manas Lokshakti Dal,11040,3,11043,S184
8683,SUSHANT KUMAR NAIK,Independent,9041,3,9044,S184
8684,LAMBODAR NAIK,Independent,6778,0,6778,S184
8685,HARIHAR MUNDA,Socialist Unity Centre Of India (COMMUNIST),6569,5,6574,S184
8686,RAGHUMANI NAIK,Independent,4550,6,4556,S184
8687,RAM PRASAD HEMBRAM,Bahujan Samaj Party,3884,11,3895,S184
8688,PITABASA NAIK,AJSU Party,2141,3,2144,S184
8689,NOTA,None of the Above,24746,17,24763,S184
8690,DINESHBHAI MAKWANA (ADVOCATE),Bharatiya Janata Party,606545,5159,611704,S068
8691,BHARAT YOGENDRA MAKWANA,Indian National Congress,321972,3295,325267,S068
8692,ANILKUMAR VASANTBHAI VAGHELA,Bahujan Samaj Party,9448,152,9600,S068
8693,BHITORA BHAVESHKUMAR CHIMANLAL,Gujarat Loktantra Party,2443,15,2458,S068
8694,SHANKARBHAI KHUSHALBHAI RATHOD,Democratic Bharatiya Samaj Party,2345,44,2389,S068
8695,VEDUBHAI KAUTIKBHAI SIRASAT,Jan Sewa Driver Party,1214,7,1221,S068
8696,NOTA,None of the Above,13604,403,14007,S068
8697,SHAFI PARAMBIL,Indian National Congress,552490,5038,557528,S113
8698,K K SHAILAJA TEACHER,Communist Party of India  (Marxist),437333,5689,443022,S113
8699,PRAPHUL KRISHNAN,Bharatiya Janata Party,110701,1278,111979,S113
8700,SHAFI T P,Independent,3715,49,3764,S113
8701,K K SHYLAJA,Independent,1164,15,1179,S113
8702,KUNHIKANNAN PAYYOLI,Independent,867,2,869,S113
8703,SHYLAJA,Independent,661,19,680,S113
8704,SHAFI,Independent,399,23,422,S113
8705,SYLAJA P,Independent,319,7,326,S113
8706,MURALIDHARAN,Independent,261,8,269,S113
8707,NOTA,None of the Above,2855,54,2909,S113
8708,ANIL YESHWANT DESAI,Shiv Sena (Uddhav Balasaheb Thackrey),393342,1796,395138,S1330
8709,RAHUL RAMESH SHEWALE,Shiv Sena,339828,1926,341754,S1330
8710,ABUL HASAN ALI HASAN KHAN,Vanchit Bahujan  Aaghadi,23675,192,23867,S1330
8711,VIDHYASAGAR ALIAS SURESH BHIMRAO VIDHYAGAR,Bahujan Samaj Party,6462,70,6532,S1330
8712,AKASH LAXMAN KHARATMAL,Independent,1891,8,1899,S1330
8713,ASHWINI KUMAR PATHAK,Independent,1607,5,1612,S1330
8714,ADV. SANTOSH PUNJIRAM SANJKAR,Independent,1565,13,1578,S1330
8715,KARAM HUSSAIN KITABULLAH KHAN,Peace Party,1533,4,1537,S1330
8716,ADV. MAHENDRA TULSHIRAM BHINGARDIVE,Right to Recall Party,1414,30,1444,S1330
8717,SAEED CHOUDHARY,Social Democratic Party Of India,1186,5,1191,S1330
8718,ISHWAR VILAS TATHAWADE,Rashtriya Mahaswaraj Bhumi Party,968,3,971,S1330
8719,DEEPAK M. CHAUGULE,Bahujan Republican  Socialist Party,968,7,975,S1330
8720,JAHID ALI NASIR AHMED SHAIKH,Aazad Samaj Party (Kanshi Ram),957,2,959,S1330
8721,DR. ARJUN MAHADEO MURUDKAR,Bharatheeya Jawan Kisan Party,913,17,930,S1330
8722,VIVEK YESHWANT PATIL,Independent,713,1,714,S1330
8723,NOTA,None of the Above,13316,107,13423,S1330
8724,JITIN PRASADA,Bharatiya Janata Party,605199,1959,607158,S2426
8725,BHAGWAT SARAN GANGWAR,Samajwadi Party,439735,2488,442223,S2426
8726,ANIS AHMED KHAN (PHOOL BABU),Bahujan Samaj Party,89252,445,89697,S2426
8727,RAJEEV KUMAR SAXENA,Bhartiya Krishak Dal,3800,9,3809,S2426
8728,SUSHIL KUMAR SHUKLA,Independent,2723,4,2727,S2426
8729,MOHMMAD SHAHID HUSAIN,Independent,1842,4,1846,S2426
8730,ASHISH KUMAR,Independent,1842,8,1850,S2426
8731,ADARSH PANDEY,Independent,1714,12,1726,S2426
8732,SANJAY KUMAR BHARTI,Rashtriya Samaj Dal (R),1621,10,1631,S2426
8733,PRAMOD BHAI PATEL ALIAS P.K.,Independent,1525,14,1539,S2426
8734,NOTA,None of the Above,6714,27,6741,S2426
8735,ASHISH DUBEY,Bharatiya Janata Party,788721,1412,790133,S1213
8736,DINESH YADAV,Indian National Congress,302892,567,303459,S1213
8737,RAKESH CHOUDHARY,Bahujan Samaj Party,21389,27,21416,S1213
8738,FOJI VIJAY HALDKAR (EX-ARMY),Independent,7028,15,7043,S1213
8739,MAHAVEER JAIN,Independent,6463,5,6468,S1213
8740,ADVOCATE UDAY KUMAR SAHU,Gondvana Gantantra Party,4832,16,4848,S1213
8741,"ER. PRAVIN GAJBHIYE ""DADA""",Independent,3437,3,3440,S1213
8742,POORNESH KUMAR JAIN,Independent,2822,1,2823,S1213
8743,SWATANATRA SAMAJ SEVI VINAY CHAKRAVARTI,Independent,2488,3,2491,S1213
8744,JAGDISH SINGH LODHI,Bhartiya Shakti Chetna Party,1871,4,1875,S1213
8745,DINESH YADAV,Independent,1480,4,1484,S1213
8746,DR. DHAI AKSHAR,Independent,1399,1,1400,S1213
8747,ASHOK RANA,Rashtra Nirman Party,1226,2,1228,S1213
8748,SANTOSH KUMAR KUSHWAHA,Independent,1202,2,1204,S1213
8749,DASAI RAM KOL,Aadim Samaj Party,1099,1,1100,S1213
8750,COMRADE SACHIN JAIN,Socialist Unity Centre Of India (COMMUNIST),868,8,876,S1213
8751,GULAB SINGH,Independent,821,8,829,S1213
8752,LAL SINGH,Rashtriya Samaj Dal (R),748,4,752,S1213
8753,RAMKUMAR PASI,Bahujan Awam Party,684,6,690,S1213
8754,NOTA,None of the Above,4964,22,4986,S1213
8755,CHHOTELAL,Samajwadi Party,465240,608,465848,S2480
8756,RINKI SINGH,Apna Dal (Soneylal),336344,270,336614,S2480
8757,DHANESHWAR,Bahujan Samaj Party,118669,109,118778,S2480
8758,ASHOK KUMAR KANNAUJIYA,Communist Party of India,23830,22,23852,S2480
8759,SUBHAGI,Janhit Sankalp Party,8191,3,8194,S2480
8760,ARVIND KUMAR BHARTI,Rashtriya Samanta Dal,7583,9,7592,S2480
8761,SUKALU,Independent,6701,11,6712,S2480
8762,SHIVPUJAN,Rashtriya Samaj Paksha,6422,22,6444,S2480
8763,SONU NIGAM,Independent,6142,2,6144,S2480
8764,CHANDRIKA PRASAD,Janta Kranti Party (Rashtravadi),3732,9,3741,S2480
8765,PRABHUDAYAL,Rashtriya Samaj Dal (R),3470,1,3471,S2480
8766,RAM SHIROMANI,Sardar Patel Siddhant Party,3116,7,3123,S2480
8767,NOTA,None of the Above,19019,13,19032,S2480
8768,JAGDAMBIKA PAL,Bharatiya Janata Party,462614,689,463303,S2460
8769,BHISHMA SHANKAR ALIAS KUSHAL TIWARI,Samajwadi Party,418910,1665,420575,S2460
8770,AMAR SINGH CHAUDHARY,Aazad Samaj Party (Kanshi Ram),81182,123,81305,S2460
8771,MD. NADEEM,Bahujan Samaj Party,35654,282,35936,S2460
8772,NAUSHAD AZAM,Peace Party,5134,4,5138,S2460
8773,KIRAN DEVI,Independent,3258,3,3261,S2460
8774,NOTA,None of the Above,9431,16,9447,S2460
8775,NILESH DNYANDEV LANKE,Nationalist Congress Party – Sharadchandra Pawar,622144,2653,624797,S1337
8776,DR. SUJAY RADHAKRISHNA VIKHEPATIL,Bharatiya Janata Party,593568,2300,595868,S1337
8777,ALEKAR GORAKH DASHRATH,Independent,44582,15,44597,S1337
8778,DEELIP KONDIBA KHEDKAR,Vanchit Bahujan  Aaghadi,13689,60,13749,S1337
8779,AMOL VILAS PACHUNDKAR,Independent,5491,2,5493,S1337
8780,BHAGWAT DHONDIBA GAIKWAD,Samata Party,4941,3,4944,S1337
8781,UMASHANKAR SHYAMBABU YADAV,Bahujan Samaj Party,4509,30,4539,S1337
8782,ADV. JAMIR SHAIKH,Independent,3934,1,3935,S1337
8783,AARTI KISHORKUMAR HALDAR,Prabuddha Republican Party,3790,9,3799,S1337
8784,NAVSHAD MUNSILAL SHAIKH,Independent,2226,0,2226,S1337
8785,SURYABHAN (ALIAS SURESH) DATTATRAYA LAMBE,Independent,2092,0,2092,S1337
8786,KALIRAM BAHIRU POPALGHAT,Bhartiya Navjawan Sena (Paksha),1975,6,1981,S1337
8787,GAVADE MACCHINDRA RADHAKISAN,Independent,1940,1,1941,S1337
8788,PRAVIN SUBHASH DALVI,Independent,1896,2,1898,S1337
8789,MADAN KANIFNATH SONVANE,Right to Recall Party,1445,6,1451,S1337
8790,DR. KAILASH NIVRUTTI JADHAV,Maharashtra Vikas Aghadi,1425,10,1435,S1337
8791,KOTHARI RAVINDRA LILACHAND,Rashtriya Janmanch (Secular),1330,3,1333,S1337
8792,ADV. SHIVAJIRAO WAMAN DAMALE (EX. SGT OF IAF),Sainik Samaj Party,1093,11,1104,S1337
8793,GANGADHAR HARIBHAU KOLEKAR,Independent,1059,0,1059,S1337
8794,DATTATRAY APPA WAGHMODE,Rashtriya Jankranti Party,868,5,873,S1337
8795,WABLE BHAUSAHEB BAPURAO,Bharatheeya Jawan Kisan Party,790,11,801,S1337
8796,SHEKATKAR ANIL GANPAT,Independent,702,0,702,S1337
8797,ADV. MAHENDRA DADASAHEB SHINDE,Independent,674,1,675,S1337
8798,BILAL GAFUR SHAIKH,Independent,531,0,531,S1337
8799,RAOSAHEB SHANKAR KALE,Independent,370,2,372,S1337
8800,NOTA,None of the Above,3254,28,3282,S1337
8801,ABHAY KUMAR SINHA,Rashtriya Janata Dal,463845,1722,465567,S0437
8802,SUSHIL KUMAR SINGH,Bharatiya Janata Party,384819,1637,386456,S0437
8803,SUNESH KUMAR,Bahujan Samaj Party,20232,77,20309,S0437
8804,PRATIBHA RANI,Peoples Party of India (Democratic),12265,43,12308,S0437
8805,RAJ BALLABH SINGH,Independent,11150,9,11159,S0437
8806,RAMJIT SINGH,Rashtriya Jansambhavna Party,9237,6,9243,S0437
8807,SURESH PRASAD VERMA,Independent,6704,7,6711,S0437
8808,MOHAMMAD WALIULLAH KHAN,Independent,6591,13,6604,S0437
8809,SHAILESH RAHI,Akhil Hind Forward Bloc (Krantikari),4892,4,4896,S0437
8810,NOTA,None of the Above,22566,61,22627,S0437
8811,SHIVRAJ SINGH CHOUHAN,Bharatiya Janata Party,1111556,4904,1116460,S1218
8812,PRATAPBHANU SHARMA,Indian National Congress,293537,1515,295052,S1218
8813,KISHAN LAL LADIYA,Bahujan Samaj Party,10734,82,10816,S1218
8814,KAMLESH KUMAR GOUR,Jai Prakash Janata Dal,8167,11,8178,S1218
8815,DHOOLSINGH DHAMMA,Independent,3417,7,3424,S1218
8816,SATYENDRA SINGH SISODIYA,Independent,2921,4,2925,S1218
8817,DHARMVIR BHARTI,Akhil Bhartiya Parivar Party,2809,10,2819,S1218
8818,ABDUL RASHID,Independent,1679,3,1682,S1218
8819,BHAI MUNSHILAL SILAWAT,Public Political Party,1114,3,1117,S1218
8820,ABDUL JABBAR,Independent,1076,6,1082,S1218
8821,SEEMA SHARMA,Sapaks Party,1065,8,1073,S1218
8822,DHARMENDRA SINGH PANWAR (GOLU BHAIYA),Right to Recall Party,1025,1,1026,S1218
8823,BHEEKAM SINGH KUSHWAHA,Mahanwadi Party,720,4,724,S1218
8824,NOTA,None of the Above,9218,62,9280,S1218
8825,JOBA MAJHI,Jharkhand Mukti Morcha,515989,4175,520164,S2710
8826,GEETA KORA,Bharatiya Janata Party,349006,2756,351762,S2710
8827,DAMODAR SINGH HANSDA,Independent,43838,454,44292,S2710
8828,MADHAV CHANDRA KUNKAL,Independent,19729,105,19834,S2710
8829,SANGRAM MARDI,Independent,16097,14,16111,S2710
8830,PARDESHI LAL MUNDA,Bahujan Samaj Party,8708,34,8742,S2710
8831,DURGA LAL MURMU,Independent,4912,12,4924,S2710
8832,CHITRASEN SINKU,Jharkhand Party,3188,22,3210,S2710
8833,BISHWA VIJAY MARDI,Ambedkarite Party of India,3067,3,3070,S2710
8834,ASHA KUMARI RUNDA,Independent,2736,18,2754,S2710
8835,KRISHNA MARDI,Jharkhand Mukti Morcha  (Ulgulan),2597,18,2615,S2710
8836,SUDHA RANI BESRA,Peoples Party of India (Democratic),2398,11,2409,S2710
8837,BIR SINGH DEOGAM,Right to Recall Party,1919,8,1927,S2710
8838,PANMANI SINGH,Socialist Unity Centre Of India (COMMUNIST),1793,8,1801,S2710
8839,NOTA,None of the Above,23907,75,23982,S2710
8840,KHADSE RAKSHA NIKHIL,Bharatiya Janata Party,629558,1321,630879,S134
8841,SHRIRAM DAYARAM PATIL,Nationalist Congress Party – Sharadchandra Pawar,358030,666,358696,S134
8842,ER. SANJAY PANDIT BRAMHANE,Vanchit Bahujan  Aaghadi,59001,119,59120,S134
8843,EKNATH NAGO SALUNKE,Independent,43957,25,43982,S134
8844,GULAB DAYARAM BHIL,Bharat Adivasi Party,9622,22,9644,S134
8845,MAMTA ALIAS MUMTAJ BHIKARI TADVI,Independent,7874,10,7884,S134
8846,VIJAY RAMKRUSHNA KALE,Bahujan Samaj Party,7551,26,7577,S134
8847,VASANT SHANKAR KOLTE,Independent,6713,5,6718,S134
8848,PRAVIN LAXMAN PATIL,Independent,6087,5,6092,S134
8849,YUVRAJ DEVSING BARELA,Independent,5131,4,5135,S134
8850,ASHOK BABURAO JADHAV,Peoples Party of India (Democratic),4686,4,4690,S134
8851,SHRIRAM SITARAM PATIL,Independent,4264,5,4269,S134
8852,JITENDRA PANDURANG PATIL,Independent,3582,5,3587,S134
8853,SANJAY PRALHAD KANDELKAR,Independent,2954,7,2961,S134
8854,SAGAR PRABHAKAR PATIL,Independent,2932,3,2935,S134
8855,SANJAYKUMAR LAXMAN WANKHEDE,Republican Party of India (Social),2277,5,2282,S134
8856,ANIL PITAMBAR WAGH (SIR),Independent,2265,13,2278,S134
8857,PROF. DR. ASHISH SUBHASH JADHAV,Independent,1919,8,1927,S134
8858,BHIVRAJ RAMDAS RAYSINGE,Independent,1807,2,1809,S134
8859,KOMALBAI BAPURAO PATIL,Independent,1424,5,1429,S134
8860,SHAIKH AABID SHAIKH BASHIR,Independent,1035,5,1040,S134
8861,AMIT HARIBHAU KOLTE,Independent,980,1,981,S134
8862,DR. YOGENDRA VITTHAL KOLTE,Independent,900,2,902,S134
8863,SHRIRAM OMKAR PATIL,Independent,743,6,749,S134
8864,NOTA,None of the Above,4073,27,4100,S134
8865,ARJUN RAM MEGHWAL,Bharatiya Janata Party,561240,5497,566737,S202
8866,GOVINDRAM MEGHWAL,Indian National Congress,506966,4060,511026,S202
8867,KHETA RAM,Bahujan Samaj Party,8249,50,8299,S202
8868,ATMA RAM GUJARATI,Independent,6267,14,6281,S202
8869,RATANI DEVI,Independent,3894,32,3926,S202
8870,SATYANARAYAN DEVRA,Independent,2958,8,2966,S202
8871,PUKHRAJ NAYAK,Independent,2621,54,2675,S202
8872,BABU LAL,Independent,2010,9,2019,S202
8873,GOPI CHAND MEGHWAL,Independent,1787,8,1795,S202
8874,NOTA,None of the Above,12431,127,12558,S202
8875,SHRIPAD YESSO NAIK,Bharatiya Janata Party,253812,3514,257326,S051
8876,RAMAKANT KHALAP,Indian National Congress,140191,1120,141311,S051
8877,TUKARAM BHARAT PARAB,Revolutionary Goans Party,45460,233,45693,S051
8878,MILAN R VAINGANKAR,Bahujan Samaj Party,1600,25,1625,S051
8879,MR SAKHARAM NAIK,Akhil Bhartiya Parivar Party,1404,13,1417,S051
8880,SHAKEEL JAMAL SHAIKH,Independent,800,7,807,S051
8881,THOMAS AUGUSTINE FERNANDES,Independent,746,13,759,S051
8882,ADV VISHAL NAIK,Independent,744,8,752,S051
8883,NOTA,None of the Above,6297,31,6328,S051
8884,RAJESH RANJAN ALIAS PAPPU YADAV,Independent,566867,689,567556,S0412
8885,SANTOSH KUMAR,Janata Dal  (United),543313,396,543709,S0412
8886,BIMA BHARTI,Rashtriya Janata Dal,27017,103,27120,S0412
8887,ARUN DAS,Bahujan Samaj Party,10595,24,10619,S0412
8888,SATYENDRA YADAV,Independent,8457,2,8459,S0412
8889,NOMAN ALAM,Independent,7693,0,7693,S0412
8890,KISHOR KUMAR YADAV,All India Forward Bloc,6846,8,6854,S0412
8891,NOTA,None of the Above,23819,15,23834,S0412
8892,ANAND KUMAR,Bharatiya Janata Party,518575,227,518802,S2456
8893,RAMESH CHANDRA,Samajwadi Party,454454,121,454575,S2456
8894,DR. BRIJESH KUMAR,Bahujan Samaj Party,50422,26,50448,S2456
8895,ARVIND KUMAR,Bhartiya Awam Party (Rastriya),6158,2,6160,S2456
8896,RAMESH BALMIKI,Independent,3223,4,3227,S2456
8897,BECHULAL,Independent,2919,1,2920,S2456
8898,JANARDAN GOND,Independent,2672,1,2673,S2456
8899,RAM MILAN,Sardar Patel Siddhant Party,1699,0,1699,S2456
8900,RINKU SAHANI,Rashtra Dharak Dal,1681,2,1683,S2456
8901,JAGRAM,Independent,1514,1,1515,S2456
8902,NOTA,None of the Above,12862,2,12864,S2456
